MGGGWGGFGGMFGGGGGGGMFFFWFFGWGFMFGGGFFFFWGGGGFGGMGGGGGWGFMWGGFGGFMMGFGGGGGGGGWFFGGGWGGWWMGGFFGGGFWFGF
GGFFWMGGFWMFGGGGFGGGFGFGGGGGMGGFGFFFGGGFFGFFMFGGWMGGFGGGGGGGFGWFGWFGGMGGFGFGFGFGGGFGFMGGGWGWFGFFGGFG
WGFGGGWGGFGFWFWGFGGFGGFFMGFFFGFWGMGFWFGGFGGFGWFGGFMGGFGGFGGGGGGGFWGFGGFGGGGGGWGMFGFFFGGGFFFFGGGMFMFG
FWGWGGGGFWGGFGGFFGWGFGGGGFGWGGGFGGGGWGGGGGGFGGGGFMFGGFWFFFWGGGFFGWGGGGGGFGFWMGGFFGGGFWGGWGGGGFFMGGFG
FGGGGGWFGFGWGGGGFGGGFWGMGMFGGFGWFGGGGMGFGWGFMGWGGFWWFGFFFFGGGWGFMGGWGGGFFGWGGGGFGGGFGGMGGFGGFFGFGFFM
WGGGFFWGGWGFFWGMGFGFFWGFGFGGGGWGFGGFGGFWWFGGFGGGGGGGGGGGGGWGWWGGFGGGFFGFWFFGFGWFGGMGFGGFGFGGGFGGFGGG
GGFFWFGGFGGFGGWFGGWWGMFGMGFWFGGWFGGFGGFGGGGGFGGGFFGGGGGGGFFWFGGMGGWGGGGGWFGGGGFFGGFGFGGGFGWGFGGGFFGF
FFGMGFFWWGMFFFGGGFFGGGFGGGGFGFGGWFWGFFGGFFGWGGWGGFGGFGWGFGGWGGGGFFGFFFFFGGWFWWGGGGWGFWGGWFWGWGGGFGWG
FGGFGGGFGGGGGGGGFFMWMGFFGGFWFFFWGFGWFGFGFGGGGGFMGGGMGFGGGGGFFGWFFMGWGFGGGGWGGGGFGGGGGWFMGFGFGGGGGWWM
WGGFGWGGGGGFGFGGGFGGGGGFGGGGGFGFFWGGGGGGGFGWGFWGFFFFGGGFGGFFGGGFGWGGWFGFFWFWFGGWFGGGGFWWFGGWWGGMGGGG
GGGGFGGGGGWGFFMGGGGWGWWGMWGGGFFFGFFGGMWGGWGGGGGFGGGFGGGMGGGGWMWFFFWMFFGWFGGGGMGGFGGGFMGGGGWGFGGWGFFF
MMWFWWGGFGGGFGGWGFGWMWGGGGGGWFGGGGMFFGGGWGGWGGWGWGGGGWGGMGGWGGGGGFGGGFGFGGFMWGMFFWGGGGGGGGFGGFGFGFGF
GFWGWGGGWGGGFGWGGGGWGGFGGGFWWGFGGGGFWGGFGGGWFWGGGWWFGGFGFWMGFFGFGGFWFMFFGFWGFWGGWGFGFGGFFFFGGGFWWFFG
MGFWGGGGGMWFFGMGGFGGGFGMGGGFFGGWWGGWGFGGGWFGGGMWGWWFFGGGMFGFFGFGGFGGGGWGGFFFMFGGWGGGGGGGGGGGGFGMFFGG
GWGWFWGGGFWFGGGWFFGFGGWGFWFGFFWGGFFGGGGGFGGWGWFFFGMGGFGMWGGGFFFGGGMGGGGGGWGFFGGGGGFGFGFWGFGWGFFGGGGF
GWGFWGGGGGFFWFGFFWGWGGFWGGWFGFGGGFGGGGGWWGGGGGGWGGGGFFMGMGWGGGFGFGGGGWGGGGGWWGMGGGGGGGGFWWMWGGGFFGFG
GFGGWFGGFGFGGGGFWFFFGGFGGGGFFWFGFGFGFWGMGGWGGWFGFWGGGGFGGFGWGGFGFGFGFWGFWFGGGGGFFGWFFFFGGMGGWGWGGGWG
GFGGFFMWFGWGWGGFGFGWGGFFGWFGMFGGGGFGGFGGGGGGGFGGFWMWGFGGGFWGGFGGFGGFGFGGFFGGGWGGWGGGGGGGWFGFMGGWGGGW
GGGGGGGGGGGGWGGFGFGFGWFFWWGGWFFGWGGFGWFGGGGGGGGFFGWGGGGGFFGWGGGFGGWGGFFGFFFFGFWFGGGGWFGGFGGFGFGWWGGW
FGWWGFGFFGGFGGGGGGGFGMGGFGGGFGGGGGFWWWGGWGGFWGGFGFGFFFWGWWGGGFGFGGFGGGFGGGGGFFFGGGGFGFGGWWGFFGFGGFGW
GWFMGGFGGFGGGGFGGGWMGFWGFWWWFWFGGWWWGFGGFFFGFMGWWGGGFMWGFWFGGGWFFGGFGFGGWFGFFFGGGGMFFGGGGGGFFGGGGFGG
MFGGWWGGFWGFWMGGMGWGGFGMGMWGGWGFGFFFGGGGFGGGGGGGGFGWFFFFWFFGMFWGWWGGGFGGMFWGGGGFFWFGGWGFGFGFGFGGGWFM
WFGFGFGGFWFGFGGWGFFGGWFWGGGFGWGGGGGMGFGFGGGGMFWGGGWGGGGGGFGGGGFGGGFGWFFGWGGFFFGGWFGWFFGGGFGGGGGFGGGG
WGWGGWGGFFGWGFWGGFGFGGFGFGGGGGGGMMGGWWGWWGWGGWWFGGWGFWGGGGGGMFGGGGGGGGFWGGGWFGGMWWGGGGGGGGGFFGGGWFGG
GWFGGFGGWGGGMMWFFGMWFFWGFFGMGFGGGGGMGWGFGGFWFFGMFGGFGMGWGMGGWWWGFGFGGWGMFGGGGGFGGFWGFGGMFGGGGGGMFFGM
FGGWGGGMGFGGGWGMWGFGGFGGGGGGGGGWWWFGGFFFMGWGFWGGWGWGFGGGGWGGGMGFWGGGFGFGGGFGWGMGFGWFGWFFFFGFFFGGGFGG
FFGGFWWGGGWFFGGGGWGWFWFFGFGGGWGWGGGFGFFWGGFGFGMGGFFFGWFGGGGGMWGGGGMFFMGGGMFMWGGFGGGFGFGGMGGGFMGGFGGF
GGGGGGGMGGGGFGGFGGGWGFWFGWGFGGGGGFGGGGGFMGFGGGGGWGGGGWGFMGGMGGMWFGFGWFGGGFGGGGFFWGGGFGFFGFFWFGFGWFGG
WGGFGGGWFFWFGGGGWWFFFGFFGGGGGGGGGGFWGFGGWGGGGGWGGFWGGGGGWGWGWGWGGGGGGGGWGGWMGGGGFGWGGGGGFGWGGGWMWGGF
WFGGFFGFWGFMGFGGFFGGGFFGGFGGGGFGFGGWWWGGMGWGGFGGGFFGGGGWGGGGGGGGFFGWWGFGGGGGWGGGGFGGGGGGFFFGGGMGFWGW
GGFFGFFFFGGFGGGGGGGGWGGGWGFGWFGFGFMGGGFGGGGGGGGGWGFGGFGFGGGGGFMGWGFGFGGFGGGMGWFGGFGMGFGFWGGGGFGGGGGG
GGGGGFGGGMFGFFGGGWFGFFGWWFGGGGFGGWFWFMFWWWGFFFGGWWFGGFWWWFWWGWGWGWFGWWWFGGGGWGFFGGFFMGWGGFWWGGGGFFGG
WMFWWFWFGGGGFFMGFGWFGGGGWWWGGGGWWGFFGMFGGGFGWFGFWGGGGGGFGFGGFGWGFFWWGGFGWFWGFGFGGGWWGFGGGGGGWGFGGGFW
GFGWGWFFWGGGGGGGGFGGGMGGGFFFGGGGGGWGGGGWGFFWGFFFGGGFFFFGGGFGGGGGWGGWWFWGFGFFGGGGGFGGGFGFGFGMWGGGGWFG
GFGGFGGFGGFGGFGGGGWGFGGMFGGGGGWFGMGGGGFMFGGGGGFGGGGGFGGFWGGWGFFGGMGFFGGWGGGGFGGFWGGGGWGFWGFGFGGGFFGF
FGGGGGFFFFFGWFFGGGGGWGFGFMWFMGFGGMGGFWFGGGFFGWGGGFGWFGGWFFGFGWGWGGGGGWFGGGFGFGFGWFGFGGMGGWWFGGFGMGGW
FWGFGFGGFGFGGGGGGGWFFFWGFGFGGGFGGGWGGGWGWGWFGFGFGFFWMGFFGGGWMGGGMGGGWGGGGMGWFFGGWWGGGGFGGGWFFWGGFGFF
GFMGGGGGGGGFFGGWGFFGFFGGGWMFFWFGMGFFFGFFFGFFFFGGGGGGGGWMGWGGGFMWFGGGGGGWGGGGWGGGGGGGGFGWGGFFWGGGFGGG
FGFWGGFGGGWGGGGFFFGGFGGGGWWGFGGGMWWFFGGFGGGFGGGWGGFGGGMGFWGMGGGFFMGGGGGFGGWGWGFFGGFGGWGGGFGFGFMGFMGF
FGWMGGFFMGFGGFGGFFFGGFWWGGGFWFGFFFFGWGGGGFGGGGGGFWFGWGFFWFGWGFFGGGGGFMFGWWWGGGGGWFFFFGFMWGFGGGGGGGGG
FGGGFGGMGFGFGFGGGFGGGFGGMGFWGFFWFFGWGGWGWGGGGFGFWGGWGWGFMGGGFGFGGGMGWGGGGWGGGGGGGFGFGFFFGWWGWFWFGGMG
FGGGGGGWFGFFFGGGGFGGGFFMGGGMFGGGGGFWFGFGWGFGWGGGFGGWGGGGMWFFGFGFFFFGGWWGGFFGGGWGGFGGGGFGGGFFFMMGGFMG
FGGGGFFGFGFWMWWGGGGWWGGGGGGFGFFGWFGGGWGGFGFFGGWMFWGFFFFGGGGGMGGFGFFFGWGFFGGGFWGWGFMFFGGFGGGFGGGWWGFW
GWGWGWGWWFWFMGFWGGFGGGGGWWGFGFMGWGFFFFGGFGGWWFFGGFMGGGFWFFGGGGGWWGFMFGWFWGGGGFGGGWGGGGGFGMMGGGFFGGGG
GGGGFFGWFGWFWWGGGGWGFGGGWFGGGGFGGGGFWGGFGGGGFFMGGFGGFFGGGGGWFGGGFFFGGGWGGFMMFGGGGGFWWWFFGFGFWFFMGGGG
GFGFWWWFGGWGGMGMFFGFGWGFGFFWFMGGFFFGGGGMGFFWFGGFFWGFFGWWFGMGFWGFFWGFGGGGWWFFFGGFGGFWFFGFWFMFFMFFGFGG
GGGGGWWGFGGGFWGWWWWWFGGGGGGFGGWFGWGGWWGGGGGWWFGGGFGGGFWGGGGGFWMFGGGFFFFWFGWGMWGGGGGFGGGWGFGFGFGWWFWG
GWGFGGFGFGGFWFFGFGGGGGGGGGGGGGMGGFGWGGGGFGGGGFMGFFGFFGFFGGMGFFGGFGGGFFWGGGGWFFGGFFGFWGGWFFGGWGFGGMGM
WWGGMGGGFGGGGFGGGGGGFGFFGFMFFWWGWGFGWGWGGWWGGGGGFWGWGFGGWMGFFFGGWGGGGGGFWFGWGGGGWFFGGGGFWFGGFGGFGWGG
FGGFWFFFFFFGGGWWGFGGGGWFFGGGGGFGGWGWGFFGFFFGGGGGFGWGGGWFGFFGFGGGFWGWFWGGMWGGFGGWFFWGWGFGGGGGFGGGGFGF
GGFWGFMMGGFGGGWFGGWGFFGFGGWGFGWWGGGGGGGFGGFFFWFGGGGGWFFGGWFFFMWWGGGGMGGGGFGGGGGGFWFGFFGGGGWGFFWGGGGG
GGGGGGGGGMGGGGFFGWGGGGFFFFGWFFFGGWMGGGFWWFWGMFFWWGFWGFWGGGGGFGGGMWWFGFWWGGGGGGGGGGGWFGFGFGGFGGGWFFFG
WGWGGGWGFWGGFGWGGFWGWWWGFGGGGWFWWGGFGWGFGGFFFFFFFGGWGGGGGGGGGGFFWFGGGGFGWGGFGWGFFGGGGWFFGGFGWFGWWGWG
FGMGGGWWFWGFGGFGGGWGFGFFWFWGFGFFWFFGGFWWWFGWGGGWGGGFMFGGGFMWGGWMGGGFGGGGGFFMWGWGMGGMGFGWGFFGGFWGMFWW
GFFWWMFGMFGGWFFWGMGGGGGGGGFFGFGWFFGWGGGFFFFGGGWGFFGGGGGFGWFGFFFGGGGGFGGFFGGGFGGGGGGGGWGWGGGMWGWWWGWF
GGWGWGGWGFGWGFWFGWFMGGWWFFGGFMWGFFGWGGGGGWGGGFGFFGWFGGFFMGWGGGFFGFGGFGFWGGGFFGGGGFWGGMGGGFWWGFGFFGWF
GGWWGGGGGGGFGFFGGWFGWGGGGFGFGFGFGWFGFFFFGWFGGFGWFFWGFMMGGGGMFFWGFWFFGGGGGGFFGGGGFFFGGWGGFGGFGFGWFMGF
FFFWFGFGGFWWFGFGGGWGFWFGFGGFGFWGFGGFWGWGFFGWGGFGGFWWGWFGGFGGFGWFWGFGFGGGGGGGFGGGWGWWGGGFFGFWGGWGGGGG
GGGGGGGFWGGFFMGGGGGWGFFMGFGGGGGGGGGWFGGGGGWGGGGGGFGGFGGFGGGFGGWGFGGWFGFWGGFGFFGGGFGFGFGGGFGGFGFGGGWF
GGGGWFFGFGGGWGFWGWGGFFGGGFFGGFGGFGWGFFGGFGFGGFFFMWMGFGGGFGGGMFGGGFFGFGWFFGGGWGWGGGGGGGFGFWGFFGFGGGWW
WGFFGWGGGFGGFWGWGWGFFGFWFWGGFWGWMGGGGFFGGGFGWWGGGGWGGMGFWGGGGGGWGFFGMWGGFGWFGFGFGGFGGGGWFGGGGGFGGFFF
GWGGFGGGGGGWMGWGWFWGGGGGFWWFWGGMWFGGFGGFFWGGGGFGWFGGFWWFFMMGWFWFGGMGGMWMFGGFGGWGGGGGGGGGFGFGGGGFMGFF
FGGGGGWWGGFFGFWGGFGFGGFFWMGGGGGGGFGFGGFFGWGGGWWGGGFGWGGFMWGGGGWGGGFFGGGGWMGMWGWFFFGGFGGFGFFGGGGWWGMG
GGFFGGFGGFGGGGGGWFGGFGGGFGFGGGFGGGWGGGGGFGGGFGGGFGGFFFGGFGGMGGFFWGGGFWGGWGGGGGFWGGGMGWGGGWGGGMGGGGGM
WGWGFFGGGGFFGGWGGGGGGGGGFGFFGGFFGGGGWGGWGFGFFGGWGGFFGGMGGGGMGFGGFFGMGGGGGGFGGGFGFMMFMFGGGGWGWGGGFGFF
GWWGGGFGWFMFGFGGGMMGGGGFGMGGGFFGMFFGMGFWGGFFGGGFGGGGGGGGMFGGGGGWGGFGGFGGGFFFFGGFGGGGGGWGWGFGGGWGWWGG
GFGGFFWFWGMFGFGWGWFFWGGFFMGGGFWGFGGGGGGGFFGGFFGGGFFGFGFGFGGGWGGGGFFWGFWGGFGFFGFFGGFFGGGWFGGWWGGFWFGG
WGGGGGFGGGFFFMGWGWGFGGFGGWFWGFMWGGMGGGGFGWGGGWGMGGWGWGFFWGWGFGGWWGGGFGGFGGMGFFFFFWMGWGFGMGFGWGGGGGMG
GGGGGWFFMFGFMGGFMGGFGGGGGFGGGGFFWGGGGWGFGWGMGGFMGGGFFFGFGGGFGFGWGGFFFGFFWGWGWGFGGGGFGGFGGWFGFFFFWWGG
WGWGGGGGFGFWWGGWGFGWGFGFWFFGMGGMGFGGGGWFGFFFGFFGGGGGFGFFFGGFWWFFGGGFGGGGWGGGFGFGGWGGGFMGFWWGFGFGGFGW
WFGWGFFMMWGMWGGFFFWGGMFGGGGFFFGFGGFGWFFGMWFGGWGGMWGGFGGGFWGMGFGFGFGWGFFGGGGGGWGGFFGFWGMGFGFGFGGWGMGF
WWGGWGWGWFGGGFWGFGFFFGGGGWWFGGFGGGGFGFGGFFGFGWGGFFGFWWFGGFFFGGWGGGGGGMGFGGFGMGGFWFGGGGGFWGGGGGGWGGGM
GGGWWGFGFWGFGGGWGGGFGGGMGFGGGFGGGGGGGMWWGGFGWFFGGFFGWFGFFGWGMWWGFWGFFFGGFGGGFFFWFWWGFMGGFGFFFGFGFGGF
FMGGWGGFGGFGGGGFGFFGGGGGGGGFGGWGGWGGWGGGGGGGGFFGMGGGGGWGGGGFGGGGGFFGGGGGGFWWGGGGGFFGGWFFFFGWGMMGGGFG
GWGFFGFMGFGGGGGMMFGGGGFGFGFMGFGGFFGGFGFWGFMGGGGFGWGFGGGFGFGMMFGGGGFGWMGGGGFWGGWWFFGFGFGGGFFGGWWGFWGG
GGFGGWMWFFWWGGFFWFFFGGFMGGMFFGFGFWFGWGWGFFFFFGGGFGGFGFFFGGGWGGFMFMGWWGGGWFGFGMWGFGFGMWGGWGGGFGGGFWGF
GGGGFGGGGGGGGWFGMGFGGGGGWWFFGWFGFGGGGMGWWGGGGGGFFGGGGGGGMGFGFGMGGGGWFFWGFGGGWGGWFMFFGGGGGGFGGGFGFWGW
MGGFFGGGWWGWGGFFWGWFGGGGGFGMFFWGGFFFFWGGWGGGGFFWWGFGGFGGFGGFFGFGGWGGGGGWFGFFWGGFWGGGGGGWGGGGGGWFGWGW
FGGGWGGWGFGWMGGMMWGGMFGGFMWWWMGGFGGFWGGFMGGFGGFGGGGGWFGWGGGGGGFFGFGGGFMGWGFGFWGMGGGFWFWFMGWFGGGGWFGW
GGFWWGGGGGGGGFGFFFGGGGWFGFGGWGGGGGGGFWGWGGWFGGGWGMGFGGFWGGGGGFGGFGGMGFWFGGMGGWGGFFGWFWWGGFWGGMFGFFGG
GGGWFFGGGGMFFGGGMWWGGWWFFGFFFGGFGGGWGGGFGGGWWMFFMGGMMWMMGGGWFGGGFFGGGFGWWGGWGFFFMWFGFMGGGWGGFGGFGGGG
FGGFGWGGGWGFGFGGFFGGFMWFGWGGFGWFGGWGGGWGGGWFFGFFFGGGMGFGWFGWGGGMGGFMWFWWFGGGFGGGFGGGFFGGFFGGWGFGGGMG
GGGFGFGGMGFGGGGGFGGGFFGFGFFMGFWGFFGGGWGGGFFGFWGGGGFGFGGGGFGGGGFGGFFFGGWGGGFGGGGMGFFFGWWWGGGFFMGFGMWG
GFGWGWFGWGFWGFFFGGFFFFGFFWGFGGFGWWGGWFFGFGGGGMWFGGFGMFGGFWGGGGWGGGGGGFGGFGMGWWGFWGGFGFGFFWWGGGGFGGGG
FGGFWFGGGMMGGGGFGGGWGGFGGGGGGGGGFWFGWFWGFWGGGFFWGGGGWGGGGWGGFGGWFFWFGMGGGGGFGGGGGGGGGGFWWGGFFGWWGFGF
GGGFFFGFGGGFGGGGFGGGFGGFGFGWGGGGGGGFGGGFWWGGGGFGFGFGGGFGGFWGGFGFGGGGFWWGGFGFMFGFGWMGGFGFWFFGGGGGGGGW
GGWGFFGGGWGWFFFGGFFFFFWFGGGGFWFWGFFWFWGGFGGGFGMFFMGGGWGFGGMGFFGGMGGFGFGFGGGFFWGGFGWGWFGMFFGFGGWMGGGG
WGGGFGGWGGWGMWGFFFGGGGGWGWFGGGWFFFMWFFWMGGMFMGMWGGMMFFGGGWGFGGFFFFGFFGGGGGWGGFFGFFGGFGGWGWGGGGGGGFFW
GFFGGWGWGGWFGGFFWGGGWWGGGGFGFGWGGFFGGGMWGGGFGFGMFFFGFGWFGFFWWFGGGGGGGFGGFGGGGGMGGGGFWGWGFGGWGFFFMGWF
MGGFWFGGGGMGGGFGGGFGFGGFGFGFGGGGFFGGGGFFGWFFWGFGFFFGGWFFFGGWGFWWGGGWGGWFWGWWFWGGGWGGGFGWFMGGGFGFFWFG
WGGFMGGGGFFGGGGGFGGGFFGWGFFGGGGGFFMWFGFFGWFGGMGMGGGFGWGFFGWGFGGFGGWFGGGMGFMFWFGGGGGGFFGFGMWGGGMFGGGG
WGGGGWGFGGFGWWGGGWGFGGGFGGGGGWMGGGGGGFFWFFFGGGGFGGGFMGGFGFMGGGGFFGGFFGGGFWFFGWFFFFFFMWWGMFGGFFGFGMGF
WWGFGFGGGGGGGWGFWFFGFGFGGFGGGGGGGWGGGFGWGMWGGFGFGGGFGMGFGGFWFGFGGGWGMFGGFGFGGGFGGFGGGMGGGFGWFMWFGGFG
WWMGGGFFGFWGMGGGGGGGMGGGGGGFGWFWWFGMGWFFGGWGGGWFGGGFFFWGGGFFFGGFWGGMGWGGGWWWGGGWWGFGGFGGGFGWFGGWWFGG
GGMGGGFWFGGGMGFFWGGFGGGGWFFWGGGFFMGFGFFWGGMWGGGGWWGFGFFFGWWGGGGGGGGFGWWGFGGWGFGGGWGFGGGFFGGGGWFGGGGG
GMWMFGGFFGGFGGFFWMGFGGGGWWWFGFWGWGFFGGGWMGWWGFMGGGGWFWGFGGMFFGWWFGWWGGGGGGWGGFFGFGFGGWGGGGFMGFFFFGGM
FGGGWGGGFWGMFFWGFGWGFGGFGWGFFGGFWGGGFGWWGGWGGGGGMWGFGFFFGWFGGGFGFMFFWWMFGGFGMFWGFMWFGFWFFFWGGGGFFWFW
WGFFFGWFFFGFGWGFGGGGFFGGFGGGFWWFFMFGGGGFWGWFGFGGGFGFFFGGFFGFGWGGGFGGFGGFGFFGWGFFGGFFGFGFGGWFGWFGGGGF
WWGGGGGWGGWFFGFFWGWGGGFGGGFWGGGGWGGWGFWGFFGGWFGGWWFFFGGWGGGGGMGGGGWGGGGWFGGGMFWGGGGGGGGWGGFFGGMWFFGW
GGGGFWGFGGWWGWGGGGGFFFGGMWGFGWGGGGGFWGFGWWWGGGFGFGGGWGGGFGFFGGGGGWMGFWGGGGGFMMFWGWGFGFGGGGGGGGMFGFWF
