GGGGGGGLLWWOOOOOOOOOOOOOOOOOOOOOOOOOOOOOOOOOOOOOOOOOOOOOOOOOOOWWLGGGGGHHGGGGGGGGGGGGGGWWOOOOOOOOOOOO
GGGGGGGLLWWOOOOOOOOOOOOOOOOOOOOOOOOOOOOOOOOOOOOOOOOOOOOOOOOOOOWWGGGGGGGGGGGGGGGGGGGGGGGWWOOOOOOOOOOO
GGGGGGGLLWWOOOOOOOOOOOOOOOOOOOOOOOOOOOOOOOOOOOOOOOOOOOOOOOOOOOWWGGGGGGGGGGGGGGGGGGGGGGGWWOOOOOOOOOOO
GGGGGGLLWWOOOOOOOOOOOOOOOOOOOOOOOOOOOOOOOOOOOOOOOOOOOOOOOOOOOOWWGGGGGGGGGGGGGGGGGGGGGGGGWWOOOOOOOOOO
GGGGGGLLWWOOOOOOOOOOOOOOOOOOOOOOOOOOOOOOOOOOOOOOOOOOOOOOOOOOOOOWWGGGGGGGGGGGGGGGGGGGGGGGGWWOOOOOOOOO
GGGGGGLLWWOOOOOOOOOOOOOOOOOOOOOOOOOOOOOOOOOOOOOOOOOOOOOOOOOOOOOWWGGGGGGGGGGGGGGGGGGGGGGGWWWOOOOOOOOO
GGGGGGLLWWOOOOOOOOOOOOOOOOOOOOOOOOOOOOOOOOOOOOOOOOOOOOOOOOOOOOOWWGGGGGGGGGGGGGGGGGGGGGGWWWWWOOOOOOOO
GGGGGGLLWWOOOOOOOOOOOOOOOOOOOOOOOOOOOOOOOOOOOOOOOOOOOOOOOOOOOOOWWGGGGGGGGGGGGGGGGGGGGGWWWWWWWOOOOOOO
GGGGGGLLWWOOOOOOOOOOOOOOOOOOOOOOOOOOOOOOOOOOOOOOOOOOOOOOOOOOOOOOWWGGGGGGGGGGGGGGGGGGGGWWWWWWWOOOOOOO
GGGGGGLLWWOOOOOOOOOOOOOOOOOOOOOOOOOOOOOOOOOOOOOOOOOOOOOOOOOOOOOOWWGGGGGGGGGGGGGGGGGGGGGWWWWWWWOOOOOO
GGGGGGGWWOOOOOOOOOOOOOOOOOOOOOOOOOOOOOOOOOOOOOOOOOOOOOOOOOOOOOOOOWWGGGGGGGGGGGGGGCHHHHHHWWWWWWOOOOOO
GGGGGGGWWOOOOOOOOOOOOOOOOOOOOOOOOOOOOOOOOOOOOOOOOOOOOOOOOOOOOOOOOWWGGGGGGGGGGGGGCCHHHHHHHGWWWWWOOOOO
GGGGGGGWWOOOOOOOOOOOOOOOOOOOOOOOOOOOOOOOOOOOOOOOOOOOOOOOOOOOOOOOOWWGGGGGGGGGGGGCCCHHHGHHHGGGWWWOOOOO
GGGGGGWWOOOOOOOOOOOOOOOOOOOOOOOOOOOOOOOOOOOOOOOOOOOOOOOOOOOOOOOOOWWGGGGGGGGGGGGCCCMMMMWWWGGGGWWOOOOO
GGGGGWWOOOOOOOOOOOOOOOOOOOOOOOOOOOOOOOOOOOOOOOOOOOOOOOOOOOOOOOOOOWWGGGGGGGGGGGHCCMMMPPPHWHGGGGWWOOOO
GGGGWWOOOOOOOOOOOOOOOOOOOOOOOOOOOOOOOOOOOOOOOOOOOOOOOOOOOOOOOOOOOWWGGGGGGGGGGGHCCCMPPPPHHHGGGGWWOOOO
GGGWWOOOOOOOOOOOOOOOOOOOOOOOOOOOOOOOOOOOOOOOOOOOOOOOOOOOOOOOOOOOOWWGGGGGGGGGGGHCCCPPPPPHHHGGGGWWOOOO
WWWWOOOOOOOOOOOOOOOOOOOOOOOOOOOOOOOOOOOOOOOOOOOOOOOOOOOOOOOOOOOOOWWGGGGGGGGGGGHCCMPPPPPHHHGGGGWWOOOO
WWWOOOOOOOOOOOOOOOOOOOOOOOOOOOOOOOOOOOOOOOOOOOOOOOOOOOOOOOOOOOOOOWWGGGGGGGGGGGHHHPPPPPPHHHGGGGWWOOOO
OOOOOOOOOOOOOOOOOOOOOOOOOOOOOOOOOOOOOOOOOOOOOOOOOOOOOOOOOOOOOOOOOWWGGGGGGGGGGHHHMPPPPPPHHHGGGGWWOOOO
OOOOOOOOOOOOOOOOOOOOOOOOOOOOOOOOOOOOOOOOOOOOOOOOOOOOOOOOOOOOOOOOWWGGGGGGGGGGGHHHMPPPPPPHHHGGLGWWOOOO
OOOOOOOOOOOOOOOOOOOOOOOOOOOOOOOOOOOOOOOOOOOOOOOOOOOOOOOOOOOOOOOOWWGGGGGGGGGGGHHHMMPPPPPHHHGGLGWWOOOO
OOOOOOOOOOOOOOOOOOOOOOOOOOOOOOOOOOOOOOOOOOOOOOOOOOOOOOOOOOOOOOOOWWGGGGGGGGGGGGHHHMPPPPPHHHGGLGWWOOOO
OOOOOOOOOOOOOOOOOOOOOOOOOOOOOOOOOOOOOOOOOOOOOOOOOOOOOOOOOOOOOOOOWWGGGGGGGGGGGGHHHMMPPPHHHGGGGWWOOOOO
OOOOOOOOOOOOOOOOOOOOOOOOOOOOOOOOOOOOOOOOOOOOOOOOOOOOOOOOOOOOOOOWWFFGGGFGGGGGGGHHHMMMPMHHHGGGGWWOOOOO
OOOOOOOOOOOOOOOOOOOOOOOOOOOOOOOOOOOOOOOOOOOOOOOOOOOOOOOOOOOOOOOWWFFFGGFFGGGGGGHHHMMMMMHHHGGGGWWOOOOO
OOOOOOOOOOOOOOOOOOOOOOOOOOOOOOOOOOOOOOOOOOOOOOOOOOOOOOOOOOOOOOOWWFFFFGGFFGGGGGHHHMMMMMHHHGGGGWWOOOOO
OOOOOOOOOOOOOOOOOOOOOOOOOOOOOOOOOOOOOOOOOOOOOOOOOOOOOOOOOOOOOOOWWFFFFFFFFFGGGGGHHRMMMHHHGGGGWWOOOOOO
OOOOOOOOOOOOOOOOOOOOOOOOOOOOOOOOOOOOOOOOOOOOOOOOOOOOOOOOOOOOOOWWFFFFFFFFFFGGGGGGHHHHHHHHGGGGWWOOOOOO
OOOOOOOOOOOOOOOOOOOOOOOOOOOOOOOOOOOOOOOOOOOOOOOOOOOOOOOOOOOOOOWWFFFFFFFFFFFGGGGGHHHHHHHGGGGGWWOOOOOO
OOOOOOOOOOOOOOOOOOOOOOOOOOOOOOOOOOOOOOOOOOOOOOOOOOOOOOOOOOOOWWWFFFFFFFFFFFGFFGGGGGHHHHGGGGGGWWOOOOOO
OOOOOOOOOOOOOOOOOOOOOOOOOOOOOOOOOOOOOOOOOOOOOOOWWWWWWWWWWWWWWWFFFFFFFFFFFFFFFFGGGGGGGGGGGGGGWWOOOOOO
OOOOOOOOOOOOOOOOOOOOOOOOOOOOOOOOOOOOOOOOOOWWWWWWWWWWWWWWWWWWGFFFFFFFFFFFFFGFFGGGGGGGGGGGGGGGWWOOOOOO
OOOOOOOOOOOOOOOOOOOOOOOOOOOOOOOOOOOWWWWWWWWWWWWWWWGGGGGGGGGGGGFFFFFFFFFGFFGFFFGGGGGGGGGGGGGGGWWOOOOO
OOOOOOOOOOOOOOOOOOOOOOOOOOOOOOOOWWWWWWWWWWGGGWWWWGGGGGGGGGGGGGFFFFFFFFGGGFGGFFGGGGGGGGGGGGGGGWWOOOOO
OOOOOOOOOOOOOOOOOOOOOOOOOOOOOOWWWWWGGGGGGGGGGGWWWGGGGGGGGGGGGGFFFFFFFFGGGGGGGGGGGGGGGGGGGGGGGGWWOOOO
OOOOOOOOOOOOOOOOOOOOOOOOOOOOWWWWFFFGGGGGGGGGGWWWWWGGGGGGGGGGGGFFFFFFGFGGGGGGGGGGGGGGGGGGGGGGGGGWWWWO
OOOOOOOOOOOOOOOOOOOOOOOOOOWWWWFFFFFFGGGGGGGGGGWWWWWGGGGGGGGGGGGGFFGGFFFGGGGGGGGGGGGGGGGFFGGGGGGGWWWW
OOOOOOOOOOOOOOOOOOOOOOOOOWWWFFFFFFFFGGGGGGHHHHHWWWWGGGGGGGGGGGGGGGGGGFGGGGGGGGGGGGGGGGGFFGGGGGGGGGGW
OOOOOOOOOOOOOOOOOOOOOOOOWWFFFFFFFFGHHHHHHHHHHHHHWWWWGGGGGGGGGGGGGGGGGGGGGGGGGGGGGGGGGGGFFFFFGGGGGGGG
OOOOOOOOOOOOOOOOOOOOOOOWWFFFFFFFHHHHHHHHHHHHHHHHWWWGGGGGGGGGGGGGGGGGGGGGGGGGGGGGGGGGGGGGFFFFFGGGGGGG
OOOOOOOOOOOOOOOOOOOOOOWWFFFFFFHHHHHHHHHHHHMMMMMHHWWWHHGGGGGGGGGGGGGGGGGGGGGGGGGGGGGGGGGGFFFFFGGGGGGG
OOOOOOOOOOOOOOOOOOOOOWWFFFFFHHHHHHHMMMMMMMMMMMMMHHWHGHHGGGGGGGGGGGGGGGGGGGGGGGGGGGGGGGFFFFFFFGGGGGGG
OOOOOOOOOOOOOOOOOOOOWWFFFFHHHHHHMMMMMMMMMMMMMMMMMHHHHWWHHGGGGGGGGGGGGGGGGGGGGGGGGGGGGGFFFFFFFFFGGGGH
OOOOOOOOOOOOOOOOOOOOWWFFFFHHHHMMMMMMMMMMMMMMMMMMMMMMMMWHHHGGGGGGGGGGGGGGGGGGGGGGGGGGGGGFFGFFFFFGGHHH
OOOOOOOOOOOOOOOOOOOWWFFFFHHHMMMMMMMMMMMMMMMMMMMMMMMMMMWHHHHHGGGGGGGGGGGGGGGGGGGGGGGGGGGGGFFFFFFGHHHH
OOOOOOOOOOOOOOOOOOOWWFFFFHHHMMMMMMMMMMMMMMMMMMMMMMMMMMMWMHHHHHHGGGGGGGHHHGGGGGGGGGGGGGGGGGFFFFFHHHHM
OOOOOOOOOOOOOOOOOOWWFFFFHHHMMMMMMMMMMMMMMMMMMMMMMMMMMMMGMMHHHHHHHHHHHHHHHHHGGGGGGGGGGGGGGGGFFFFCCCMM
OOOOOOOOOOOOOOOOOOWWGFFFHHHMMMMMMMMMMMMMMMMMMMMMMMMMMMMMMMMMHHHHHHHHHHHHHHHHGGGGGGGGGGGGGGGGGFCCCCCM
OOOOOOOOOOOOOOOOOOWWFFFFHHHMMMMMMMMMMMMMMMMMMMMMMMMMMMMMMMMMMMMHHHHHHHMMMHHHHGGGGGGGGGGGGGGGGGCCCCMP
OOOOOOOOOOOOOOOOOOWWGFFFHHHMMMMMMMMMMMMMMMMMMMMIIIIIIMMMMMMMMMMMMMMMMMMMMMHHHGGGGGGGGGGGGGGGGGHHCMMP
OOOOOOOOOOOOOOOOOWWGGGFHHHMMMMMMMMMMMMMMMMMMMMMMMMMMMMMMMMMMMMMMMMMMMMMMMMHHHGGGGGGGGGGGGGGGGHHHMMPP
OOOOOOOOOOOOOOOOOWWGGGGHHHMMMMMMMMMMMMMMMMMMMMMMMMMMMMMMMMMMMMMMMMMMMMMMMMHHHGGGGGGGGGGGGGGGGHHHMMPP
OOOOOOOOOOOOOOOOOWWGGGGHHHMMMMMMMMMMMMMMMMMMMMMMMMMMMMMMMMMMMMMMMMMMMMMMMMMHHHGGGGGGGGGGGGGGGHHHMMPP
OOOOOOOOOOOOOOOOOWWGGGGHHHMMMMMMMMMMMMMMMMMMMMMMMMMMMMMMMMMMMMMMMMMMMMMMMMMHHHGGGGGGGGGGGGGGGHHHMPPP
OOOOOOOOOOOOOOOOOWWGGGGHHHMMMMMMHHHHHHHHHHHHHHHHHHHHHMMMMMMMMMMMMMMMMMMMMMMHHHGGGGGGGGGGGGGGHHHMMPPP
OOOOOOOOOOOOOOOOWWGGGGHHHMMHHHHHHHHHHHHHHHHHHHHHHHHHHHHHHHHHMMMMMMMMMMMMMMMMHHHGGGGGGGGGGGGGHHHMMPPP
OOOOOOOOOOOOOOOOWWGGGGHHHHHHHHHHHHHHHHHHHHHHHHHHHHHHHHHHHHHHHHMMMMMMMMMMMMMMMHHHGGGGGGGGGGGHHHMMMPPP
OOOOOOOOOOOOOOOWWGGGGHHHHHHHHHHHGGGGGGGGGGGGGGGGGFFFFHHHHHHHHHHHMMMMMMMMMMMMMMHHHGGGGGGGGHHHHMMMPPPP
OOOOOOOOOOOOOOOWWGGGGGGHHHHGGGGGGGGGGGGGGGGGGGGGGFFFFFFFFGGGHHHHHMMMMMMMMMMMMMMHHHHGGGGHHHHHMMMMPPPP
OOOOOOOOOOOOOOWWGGGGGGGGGGGGGGGGGGGGGGGGGGGGGGGGGGFFFFFFFFFFFFHHHHMMMMMMMMMMMMMIHHHHHHHHHHHMMMMMPPPP
OOOOOOOOOOOWWWWGGGGGGGGGGGGGGGGGGGGGGFFFFGGGGGGGGGFFFFFFFFFFFFGGHHHMMMMMMMMMMMMIIHHHHHHHHMMMMMMPPPPP
OOWWWWWWWWWWWWGGGGGGGGGGGGGGGGGGGGGGFFGFFFFGGGGGLLFFFFFFFFFFFFGGGRRHMMMMMMMMMMMMMMMHHHHMMMMMMMPPPPPP
WWWWWWWWWWWGGGGGGGGGGGGGGGGGGGGGGGGGGFFFFFFFFGGGWLLFFFFFFFFFFFFFGGRRHMMMMMMMMMMMMMMMMMMMMMRMMPPPPPPP
WWGGGGLLLGGGGGGGGGGGGGGGGGGGGGGGGGGGGGFFFFFFFFFWWWLFFGFFFFFFFFFFFFGHHHMMMMMMMMMMMMMMMMMMMMPPPPPPPPPP
GGGGGGGLGGGGGGGGGGGGGGGGGGGGGGGGGGGGGGFFFFFFFFWWWWWGGFFFFFFFFFFFFFFGHHHMMMMMMMMMMMMMMMMPPPPPPPPPPPPP
GGGGGGGGGGGGGGGGGGGGGGGGGGGLLLLGGGGGGFFFFFFFFWWWWWWWWGFFFFFFFFFFFFFFHHHMMMMMMMMMMMMMPPPPPPPPPPPPPPPP
GGGGGGGGGGGGGGGGGGGGGGGGGGGLLLGGGGGGGGFFFFFFWWWWWWWWWWFFFFFFFFFFFFFFFHHHMMMMMMMMMMMPPPPPPPPPPPPPPPPP
GGHHGGGGGGGGGGGGGGGGGGGGGGGWWWWWWWGGGGGFWWWWWWWWFWFFWWGFFFFFFFFFFFFFFHHHMMMMMMMMMMPPPPPPPPPPPPPPPPPP
HHHHHGGGGGGGGGGGGGGGGGGWWWWWWWWWWWWWWGFWWWWWWWFFFFFFFFWGGFFFFFFGFGGFGHHHMMMMMMMMMMPPPPPPPPPPPPPPPPPP
HHHHHHGGGGGGGGGGGGGGGWWWWWWOOOOOOOWWWWWWWWWWWWWFFFFFFWWWGGGFFGFGGGGGGHHHMMMMMMMMMPPPPPPPPPPPPPPPPPPP
HHMHHHGGGGGGGGGGGGGGWWWOOOOOOOOOOOOOOWWWWWWWWWFFFFFFWWWFFGGGFFGGGGGGGHHHMMMMMMMMMPPPPPPPPPPPPPPPPPPP
MMMHHHGGGGGGGGGGGGGWWOOOOOOOOOOOOOOOOOOOWWWWWFFFFFFWWWWWFGGGGGGGGGGGHHHMMMMMMMMMMMPPPPPPPPPPPPPPPPPP
MMMHHHFGGGGGGGGGGGWWOOOOOOOOOOOOOOOOOOOOOWWFFFFFFFFWWWWWWGGGGGGGGGGGHHHMMMMMMMMMMMPPPPPPPPPPPPPPPPPP
MMMHHHFFGGGGGGGGGWWOOOOOOOOOOOOOOOOOOOOOOWWFFFFFFGGGWWWWWWGGGGGGGGGHHHMMMMMMMMMMMMPPPPPPPPPPPPPPPPPP
HHHHHHFFGGGFGGGGWWOOOOOOOOOOOOOOOOOOOOOOOWWGFFFFFGGGGGWWWWGGGGGGGGHHHMMMMMMMMMMMMMPPPPPPPPPPPPPPPPPP
HHHHHFFFFGFFGGGGWWOOOOOOOOOOOOOOOOOOOOOOWWGGGFFFGGGGGGWWWWGGGGGGHHHHMMMMMMMMMMMMMMPPPPPPPPPPPPPPPPPP
HHHHFFFFFFFFFFGWWOOOOOOOOOOOOOOOOOOOOOOOWWGGGGFGGGGGGGGWWWWGGHHHHHHMMMMMMMMMMMMMMMMPPPPPPPPPPPPPPPPP
FFFFFFFFFFFFFFGWWOOOOOOOOOOOOOOOOOOOOOOOWWGGGGGGGGGGHHHHWWWWHHHHHHMMMMMMMMMMMMMMMMMMPPPPPPPPPPPPPPPP
FFFFFFFFFFFFFFFWWOOOOOOOOOOOOOOOOOOOOOOWWGGGGGGGGHHHHHHCCWWWWHHHMMMMMMMMMMMMMMMMMMMMMPPPPPPPPPPPPPPP
FFFFFFFFFFFFFFWWOOOOOOOOOOOOOOOOOOOOOOWWGGGGGGGHHHHHHHCCCCWWWWWWWMMMMMMMCMMMMMMMMMMMMMPPPPPPPPPPPPPP
FFFFFFFFFFFGGGWWOOOOOOOOOOOOOOOOOOOOOOWWGGGGGGHHHHHHPPPPPPMWWWWWWWMMMMMMMMMMMMMMMMMMMMMPPPPPPPPPPPPP
FFFFFFFFFFFGGGWWOOOOOOOOOOOOOOOOOOOOOWWGGGGGGHHHHPPPPPPPPPPPPMWWWWWMMMMMMMMMMMMMMMMMMMMMPPPPPPPPPPPP
GFFFFFFFFFFGGWWOOOOOOOOOOOOOOOOOOOOWWWGGGGGGGHHHPPPPPPPPPPPPPPPMWWWWMMMMMMMMMMMMMMMMMMMMMPPPPPPPPPPP
GGFFGFFFFFFFGWWOOOOOOOOOOOOOOOOOOOWWWGGGGGGGGHHHPPPPPPPPPPPPPPPPMWWWWMWWMMMMMMMMMMMMMMMMMPPPPPPPPPPP
GGGGGGFFFFFFGWWOOOOOOOOOOOOOOOOOWWWGGGGGGGGGHHHPPPPPPPPPPPPPPPPPPWWWWWMMWWMWWMMMMMMMMMMMMMPPPPPPPPPP
GGGGGGGGGGGGGWWOOOOOOOOOOOOOOOOWWWFFFGGGGGGGHHHPPPPPPPPPPPPPPPPPPMWWWMMMMMWWWWMMMMMMGMMMMMPPPPPPPPPP
GGGGGGGGGGGGGWWOOOOOOOOOOOOOOWWWFGGFFFGGGGGGHRHPPPPPPPPPPPPPPPPPPMMMMMMMMMMWMWWWWWMWMMMMMMPPPPPPPPPP
GGGGGGGGGGGGWWOOOOOOOOOOOOOWWWWFFFFGFFGGGGGGRRRPPPPPPPPPPPPPPPPPPMMMMMMMMMMMMMMMMMWMMMMMMMMPPPPPPPPP
GGGGGGGGGGGWWOOOOOOOOOOOOWWWWFFFFFFFFFFFFGGGRRRPPPPPPPPPPPPPPPPPMMMMMMMMMMMMMMMMMMMMMMMMMMMPPPPPPPPP
LGGGGGGGGWWWOOOOOOOOOOOWWWWFFFFFFFFFFFFFFGGGRRRPPPPPPPPPPPPPPPPPMMMMMMMMMMMMMMMMHHHHHHHMMMMMPPPPPPPP
LGGWWWWWWWWOOOOOOOOOOOWWWGFFFFFFFFFFFFFFFGGHRRMPPPPPPPPPPPPPPPPMMMMMMMMMMMMMMHHHHHHHHHHHHMMMPPPPPPPP
WWWWWWWWWOOOOOOOOOOOWWWGGFFFFFFFFFFFFFFFFGGHHHMPPPPPPPPPPPPPPPPMMMMMMMMMMMHHHHHHHHHHHHHHHHMMMPPPPPPP
WWWOOOOOOOOOOOOOOOOWWWGGFFFFFFFFFFFFFFFFGGGHHHMPPPPPPPPPPPPPPPMMMMMMMMMHHHHHHHHHGGGGGGGHHHHMMMPPPPPP
OOOOOOOOOOOOOOOOOOWWGGGGGFFFFFFFFFFFFFFFFGGHHHMPPPPPPPPPPPPPPPMMMMMMHHHHHHHHHGGGGGGGGGGGGHHHMMPPPPPP
OOOOOOOOOOOOOOOOOWWGGGGGGFFFFFFFFFFFFFFGGGGHHHMPPPPPPPPPPPPPPMMMMMMHHHHHHHGGGGGGGGGGGGGGGGHHHMMPPPPP
OOOOOOOOOOOOOOOOOWWGGGGGGGFFFFFFFFFFFFFFFGGHHHMPPPPPPPPPPPPPPMMMMMHHHHHGGGGGGGGGGGGGGGGGGGGHHHMCPPPP
OOOOOOOOOOOOOOOOWWGGGGGGGGGFFFFFFFFFFFFFFGGHHHMMPPPPPPPPPPPPMMMMMHHHGGGGGGGGGGGGGGGGGGGGGGGGHHHCPPPP
OOOOOOOOOOOOOOOOWWGGGGGGGGGGGFFFFFFFFFFFFFFHHHMMPPPPPPPPPPPPMMMMHHHGGGGGGGGGGGGGGGGGGGGGGGGGHHHCCPPP
OOOOOOOOOOOOOOOOWWGGGGGGGGGGGGFFFFGFFFGFFFHHHMMMPPPPPPPPPPPMMMMHHHGGGGGGGGGGGGGGGGGGGGGGGGGGGHHCCCPP
