OOOOOOOOOOOOOOOOOOOOOOOOOOWWWWWWWWWWWWWWWWWWWWWWWOOOOOOOOOOWWWGGGGGGGGGGGGGGGGGGGGGGGGGGGGGGGGGGGGGGGGGGGGGGGWWWOOOOOOOOOOOOOOOOOOOOOWWWWWWWWWWWWWWWWW
OOOOOOOOOOOOOOOOOOOOOOOOOOWWWWWWWWWWWWWWWWWWWWWWOOOOOOOOOOOWWWGGGGGGGGGGGGGGGGGGGGGGGGGGGGGGGGGGGGGGGGGGGGGGGWWWOOOOOOOOOOOOOOOOOOOOOWWWWWWWWWWWWWWWWW
OOOOOOOOOOOOOOOOOOOOOOOOOOWWWWWWWWWWWWWWWWWWWWWWOOOOOOOOOOOWWWGGGGGGGGGGGGGGGGGGGGGGGGGGGGGGGGGGGGGGGGGGGGGGGWWWOOOOOOOOOOOOOOOOOOOOOWWWWWWWWWWWWWWWWW
OOOOOOOOOOOOOOOOOOOOOOOOOOWWWWWWWWWWWWWWWWWWWWWWOOOOOOOOOOOWWWGGGGGGGGGGGGGGGGGGGGGGGGGGGGGGGGGGGGGGGGGGGGGGWWWOOOOOOOOOOOOOOOOOOOOOOWWWWWWWWWWWWWWWWW
OOOOOOOOOOOOOOOOOOOOOOOOOOWWWWWWWWWWWWWWWWWWWWWWOOOOOOOOOOOWWWGGGGGGGGGGGGGGGGGGGGGGGGGGGGGGGGGGGGGGGGGGGGGGWWWOOOOOOOOOOOOOOOOOOOOOOOWWWWWWWWWWWWWWWW
OOOOOOOOOOOOOOOOOOOOOOOOOOOWWWWWWWWWWWWWWWWWWWWOOOOOOOOOOOOWWWGGGGGGGGGGGGGGGGGGGGGGGGGGGGGGGGGGGGGGGGGGGGGGWWWOOOOOOOOOOOOOOOOOOOOOOOWWWWWWWWWWWWWWWW
OOOOOOOOOOOOOOOOOOOOOOOOOOOOWWWWWWWWWWWWWWWWWWWOOOOOOOOOOOOWWWGGGGGGGGGGGGGGGGGGGGGGGGGGGGGGGGGGGGGGGGGGGGGWWWOOOOOOOOOOOOOOOOOOOOOOOOWWWWWWWWWWWWWWWW
OOOOOOOOOOOOOOOOOOOOOOOOOOOOOWWWWWWWWWWWWWWWWWOOOOOOOOOOOOOWWWGGGGGGGGGGGGGGGGGGGGGGGGGGGGGGGGGGGGGGGGGGGGGWWWOOOOOOOOOOOOOOOOOOOOOOOOOWWWWWWWWWWWWWWW
OOOOOOOOOOOOOOOOOOOOOOOOOOOOOOWWWWWWWWWWWWWWWOOOOOOOOOOOOOOWWWGGGGGGGGGGGGGGGGGGGGGGGGGGGGGGGGGGGGGGGGGGGGWWWOOOOOOOOOOOOOOOOOOOOOOOOOOOWWWWWWWWWWWWWW
OOOOOOOOOOOOOOOOOOOOOOOOOOOOOOOOWWWWWWWWWWWOOOOOOOOOOOOOOOOWWWGGGGGGGGGGGGGGGGGGGGGGGGGGGGGGGGFFFFFGGGGGGGWWWOOOOOOOOOOOOOOOOOOOOOOOOOOOOWWWWWWWWWWWWW
OOOOOOOOOOOOOOOOOOOOOOOOOOOOOOOOOOOWWWWWOOOOOOOOOOOOOOOOOOOWWWGGGGGGGGGGGGGGGGGGGGGGGGGGGFGGGGGFFFFGGGGGGWWWOOOOOOOOOOOOOOOOOOOOOOOOOOOOOOWWWWWWWWWWWW
OOOOOOOOOOOOOOOOOOOOOOOOOOOOOOOOOOOOOOOOOOOOOOOOOOOOOOOOOOOWWWGGGGGGGGGGGGGGGGGGGGGGGGGGFFGFFGFFFFFGGGGGWWWOOOOOOOOOOOOOOOOOOOOOOOOOOOOOOOOOWWWWWWWWWW
OOOOOOOOOOOOOOOOOOOOOOOOOOOOOOOOOOOOOOOOOOOOOOOOOOOOOOOOOOOWWWGGGGGGGGGGGGGGGGGGGGGGGGGGFFFFFFFFFFGGGGGGWWWOOOOOOOOOOOOOOOOOOOOOOOOOOOOOOOOOOOOOOWWWWW
OOOOOOOOOOOOOOOOOOOOOOOOOOOOOOOOOOOOOOOOOOOOOOOOOOOOOOOOOOOWWWGGGGGGGGGGGGGGGGGGGGFGGGFFGFFFFFFFFFGFGGGWWWOOOOOOOOOOOOOOOOOOOOOOOOOOOOOOOOOOOOOOOOOOOO
OOOOOOOOOOOOOOOOOOOOOOOOOOOOOOOOOOOOOOOOOOOOOOOOOOOOOOOOOOOWWWGFGGGGGGGGGGGGGGGGGFFFGGFFFFFFFFFFFFFFFGWWWOOOOOOOOOOOOOOOOOOOOOOOOOOOOOOOOOOOOOOOOOOOOO
OOOOOOOOOOOOOOOOOOOOOOOOOOOOOOOOOOOOOOOOOOOOOOOOOOOOOOOOOOOWWWFFFGGGFFFGGGGGGGGGGFFFFFFFFFFFFFFFFFFFFWWWOOOOOOOOOOOOOOOOOOOOOOOOOOOOOOOOOOOOOOOOOOOOOO
OOOOOOOOOOOOOOOOOOOOOOOOOOOOOOOOOOOOOOOOOOOOOOOOOOOOOOOOOOWWWGFFFFGGFFFFFFFGGGGGGGFFFFFFFFFFFFFFFFFFFWWWOOOOOOOOOOOOOOOOOOOOOOOOOOOOOOOOOOOOOOOOOOOOOO
OOOOOOOOOOOOOOOOOOOOOOOOOOOOOOOOOOOOOOOOOOOOOOOOOOOOOOOOOOWWWGGFFFFFGFFFFFFGFGFGGGGFFFFFFFFFFFFFFFFFWWWOOOOOOOOOOOOOOOOOOOOOOOOOOOOOOOOOOOOOOOOOOOOOOO
OOOOOOOOOOOOOOOOOOOOOOOOOOOOOOOOOOOOOOOOOOOOOOOOOOOOOOOOOOWWWGGFFFFFGFFFFFFFFFFFFFGGFFFFFFFFFFFFFFFWWWOOOOOOOOOOOOOOOOOOOOOOOOOOOOOOOOOOOOOOOOOOOOOOOO
OOOOOOOOOOOOOOOOOOOOOOOOOOOOOOOOOOOOOOOOOOOOOOOOOOOOOOOOOOWWWFFFFFFFFFFFFFFFFFFFFFFGFFFFFFFFFFFFFFFWWWOOOOOOOOOOOOOOOOOOOOOOOOOOOOOOOOOOOOOOOOOOOOOOOO
OOOOOOOOOOOOOOOOOOOOOOOOOOOOOOOOOOOOOOOOOOOOOOOOOOOOOOOOOOWWWFFFFFFFFFFFFFFFFFFFGFFGFFFFGFFFFFFFFFWWWOOOOOOOOOOOOOOOOOOOOOOOOOOOOOOOOOOOOOOOOOOOOOOOOO
OOOOOOOOOOOOOOOOOOOOOOOOOOOOOOOOOOOOOOOOOOOOOOOOOOOOOOOOOOWWWGFFFFFFFFFFGFFFFFFFFFGGGGFFFFFFFFFFFFWWWOOOOOOOOOOOOOOOOOOOOOOOOOOOOOOOOOOOOOOOOOOOOOOOOO
OOOOOOOOOOOOOOOOOOOOOOOOOOOOOOOOOOOOOOOOOOOOOOOOOOOOOOOOOOWWWFFFFFFFFFFFFFFFGFFFFFFGGGFFFFFFFFFFFWWWOOOOOOOWWWWWWWWWWWOOOOOOOOOOOOOOOOOOOOOOOOOOOOOOOW
OOOOOOOOOOOOOOOOOOOOOOOOOOOOOOOOOOOOOOOOOOOOOOOOOOOOOOOOOOWWWFFFFFFFFFFFFFFFFFFFFFGGGGFFFFFFFFFFFWWWOOOOWWWWWWWWWWWWWWWWOOOOOOOOOOOOOOOOOOOOOOOOOOOOWW
OOOOOOOOOOOOOOOOOOOOOOOOOOOOOOOOOOOOOOOOOOOOOOOOOOOOOOOOOOOWWWFFFFFFFFFFFFFFFFFFFGFGGFFFFFFFFFFFFWWWOWWWWWWWWWWWWWWWWWWWWOOOOOOOOOOOOOOOOOOOOOOOOOWWWW
OOOOOOOOOOOOOOOOOOOOOOOOOOOOOOOOOOOOOOOOOOOOOOOOOOOOOOOOOOOWWWGGFFFFFFFFFFFFFFFFFGFFGGFFFFFFFFFFWWWWWWWWWWWWWWWWWWWWWWWWWWOOOOOOOOOOOOOOOOOOOOOOOWWWWG
OOOOOOOOOOOOOOOOOOOOOOOOOOOOOOOOOOOOOOOOOOOOOOOOOOOOOOOOOOOWWWGLGFFFFFFFFFFFFFFFFFFFGFFFFGFFFFFFWWWWWWWWWWWWWWWWWWWWWWWWWWOOOOOOOOOOOOOOOOOOOOOOWWWWGG
OOOOOOOOOOOOOOOOOOOOOOOOOOOOOOOOOOOOOOOOOOOOOOOOOOOOOOOOOOOWWWGLGGFFFFFFFFFFFFFFFFGFGGFFFFFFFFFFWWWWWWWWWWWWWWWWWWWWWWWWWWWOOOOOOOOOOOOOOOOOOOOWWWLLLG
OOOOOOOOOOOOOOOOOOOOOOOOOOOOOOOOOOOOOOOOOOOOOOOOOOOOOOOOOOOOWWWLGGFFFFFFFFFFFFFFFGGGGFFGGFFFFFFFWWWWWWWWWWWWWWWWWWWWWWWWWWWOOOOOOOOOOOOOOOOOOOWWWLLLGG
OOOOOOOOOOOOOOOOOOOOOOOOOOOOOOOOOOOOOOOOOOOOOOOOOOOOOOOOOOOOWWWGGGGFFFFFFFFFGGFGFFGGGGGGGFFFFFFFWWWWWWWWWWWWWWWWWWWWWWWWWWWWOOOOOOOOOOOOOOOOOWWWGLGGGG
OOOOOOOOOOOOOOOOOOOOOOOOOOOOOOOOOOOOOOOOOOOOOOOOOOOOOOOOOOOOWWWGGGGFFFFFFFFFFGGGGGGGGGGGGGFFFFFFFWWWWWWWWWWWWWWWWWWWWWWWWWWWOOOOOOOOOOOOOOOWWWWGGGGGGG
OOOOOOOOOOOOOOOOOOOOOOOOOOOOOOOOOOOOOOOOOOOOOOOOOOOOOOOOOOOOWWWGGGGFFFFFFFFFFGGGGGGGGGGGGGGFFFFFFWWWWWWWWWWWWWWWWWWWWWWWWWWWOOOOOOOOOOOOOOWWWWGGGGGGGG
OOOOOOOOOOOOOOOOOOOOOOOOOOOOOOOOOOOOOOOOOOOOOOOOOOOOOOOOOOOOOWWWGGGFFFFFFFFGFFGGGGGGGGGGGGGGFFFFFFWWWWWWWWWWWWWWWWWWWWWWWWWWOOOOOOOOOOOOWWWWWGGGGGGGGG
OOOOOOOOOOOOOOOOOOOOOOOOOOOOOOOOOOOOOOOOOOOOOOOOOOOOOOOOOOOOOWWWGGGFFFFFFGFFGFFGGGGGGGGGGGGFFFFFFFWWWWWWWWWWWWWWWWWWWWWWWWWWOOOOOOOOOOWWWWWGGGGGGGGGGG
OOOOOOOOOOOOOOOOOOOOOOOOOOOOOOOOOOOOOOOOOOOOOOOOOOOOOOOOOOOOOWWWGGGGGFFGGGGGGGGGGGGGGGGGGGGGGFGFFFFWWWWWWWWWWWWWWWWWWWWWWWWWOOOOOOOWWWWWWWGGGGGGGGGGGG
WOOOOOOOOOOOOOOOOOOOOOOOOOOOOOOOOOOOOOOOOOOOOOOOOOOOOOOOOOOOOWWWGGGGGGGFGGGGGGGGGGGGGGGGGGGGGGGGGFFGWWWWWWWWWWWWWWWWWWWWWWWWOOOWWWWWWWWWGGGGGGGGGGGGGG
WWOOOOOOOOOOOOOOOOOOOOOOOOOOOOOOOOOOOOOOOOOOOOOOOOOOOOOOOOOOOWWWGGGGGGGGGGGGGGGGGGGGGGGGGGGGGGGGGGGGWWWWWWWWWWWWWWWWWWWWWWWWWWWWWWWWWWGGGGGGGGGGGGGGGG
WWWOOOOOOOOOOOOOOOOOOOOOOOOOOOOOOOOOOOOOOOOOOOOOOOOOOOOOOOOOOWWWGGGGGGGGGGGGGGGGGGGGGGGGGGGGGGGGGGGGGWWWWWWWWWWWWWWWWWWWWWWWWWWWWWWWWGGGGGGGGGGGGGGGGG
WWWOOOOOOOOOOOOOOOOOOOOOOOOOOOOOOOOOOOOOOOOOOOOOOOOOOOOOOOOOOWWWGGGGGGGGGGGGGGGGGGGGGGGGGGGGGGGGGGGGGGGWWWWWWWWWWWWWWWWWWWWWWWWWWWWWGGGGGGGGGGGGGGGGGG
WWWOOOOOOOOOOOOOOOOOOOOOOOOOOOOOOOOOOOOOOOOOOOOOOOOOOOOOOOOOOWWWGGGGGGGGGGGGGGGGGGGGGGGGGGGGGGGGGGGGGGGGWWWWWWWWWWWWWWWWWWWWGGGGWWWWGGGGGGGGGGGGGGGGGG
WWOOOOOOOOOOOOOOOOOOOOOOOOOOOOOOOOOOOOOOOOOOOOOOOOOOOOOOOOOOOWWWGGGGGGGGGGGGGGGGGGGGGGGGGGGGGGGGGGGGGGGGGGWWWWWWWWWWWWWWWGGGGGGWWWWWWGGGGGGGGGGGGGGGGG
WWOOOOOOOOOOOOOOOOOOOOOOOOOOOOOOOOOOOOOOOOOOOOOOOOOOOOOOOOOOOWWWGGGGGGGGGGGGGGGGGGGGGGGGGGGGGGGGGGGGGGGGLLLGGGWWWWWWGGLLGGGGGGWWWWWWGGGGGGGGGGGGGGGGGG
WOOOOOOOOOOOOOOOOOOOOOOOOOOOOOOOOOOOOOOOOOOOOOOOOOOOOOOOOOOOOWWWGGGGGGGGGGGGGGGGGGGGGGGGGGGGGGGGGGGGGGGGGGLGGGGGGGGGGGLLLGGGGGGWWWWGGGGGGGGGGGGGGGGGGG
OOOOOOOOOOOOOOOOOOOOOOOOOOOOOOOOOOOOOOOOOOOOOOOOOOOOOOOOOOOOOWWWGGGGGGGGGGGGGGGGGGGGGGGGGGGGGGGGGGGGGGGGGGGGGGGGGGGGGGGGGGGGGGGGWWGGGGGGGGGGGGGGGGGGGG
OOOOOOOOOOOOOOOOOOOOOOOOOOOOOOOOOOOOOOOOOOOOOOOOOOOOOOOOOOOOOWWWGGGGGGGGGGGGGGGGGGGGGGGGGGGGGGGGGGGGGGGGGGGGGGGGGGGGGGGGGGGGGGGGGWWGGGGGGGGGGGGGGGGGGG
OOOOOOOOOOOOOOOOOOOOOOOOOOOOOOOOOOOOOOOOOOOOOOOOOOOOOOOOOOOOOWWWGFGGGGGGGGGGGGGGGGGGGGGGGGGGGGGGGGGGGGGGGGGGGGGGGGGGGGGGGGGGGGGGWWWWGGGGGGGGGGGGGGGGGG
OOOOOOOOOOOOOOOOOOOOOOOOOOOOOOOOOOOOOOOOOOOOOOOOOOOOOOOOOOOOOWWWFFFGGGGGGGGGGGGGGGGFFFFFFFFGFFFGGGGGGGGGGGGGGGGGGGGGGGGGGGGGGGGGGWWGGGGGGGGGGGGGGGGGGG
OOOOOOOOOOOOOOOOOOOOOOOOOOOOOOOOOOOOOOOOOOOOOOOOOOOOOOOOOOOOOWWWFFFFGFFFGGGGGGGGGGFFFFFGFFFFGFFGGGGGGGGGGGGGGGGGGGGGGGGGGGGGGGGGWWGGGGGGGGGGGGGGGGGGGG
OOOOOOOOOOOOOOOOOOOOOOOOOOOOOOOOOOOOOOOOOOOOOOOOOOOOOOOOOOOOOWWWFFFFFFFFFFGGGGGGGFFFFFFFFFFFFFFFGGGGGGGGGGGGGGGGGGGGGGGGGGGGGGGGWWWGGGGGGGGGGGGGGGGGGG
OOOOOOOOOOOOOOOOOOOOOOOOOOOOOOOOOOOOOOOOOOOOOOOOOOOOOOOOOOOOOWWWFFFFFFFFFFGGGGGGGGFFFFFFFFFFFFFGGGGGGGGGGGGGGGGGGGGGGGGGGGGGGGGGGWWWGGGGGGGGGGGGGGGGGG
OOOOOOOOOOOOOOOOOOOOOOOOOOOOOOOOOOOOOOOOOOOOOOOOOOOOOOOOOOOOOWWWFFFFFFFFFFFFGGGGGGFFFFFFFFFFFFFFGGGGGGGGGGGGGGGGGGGGGGGGGGGGGGGGGGWGGGGGGGGGGGGGGGGGGG
OOOOOOOOOOOOOOOOOOOOOOOOOOOOOOOOOOOOOOOOOOOOOOOOOOOOOOOOOOOOOWWWFFFFFFFFFFFFFGGGGFFFFFFFFFFFFFFFFGGGGGGGGGGGGGGGGGGGGGGGGGGGGGGGGWWWGGGGGGGGGGGGGGGGGG
OOOOOOOOOOOOOOOOOOOOOOOOOOOOOOOOOOOOOOOOOOOOOOOOOOOOOOOOOOOOOWWWFFFFFFFFFFFFFFGGFFFFFFFFFFFFFFFFFFGFFGGGGGGGGGGGGGGGGGGGGGGGGGGGWWWGGGGGGGGGGGGGGGGGGG
OOOOOOOOOOOOOOOOOOOOOOOOOOOOOOOOOOOOOOOOOOOOOOOOOOOOOOOOOOOOOWWWFFFFFFFFFFFFFFFFGFFFFFFFFFFFFFFFFFFFFFFGGGGGGGGGGGGGGGGGGGGGGGGWWWGGGGGGGGGGGGGGGGGGGG
OOOOOOOOOOOOOOOOOOOOOOOOOOOOOOOOOOOOOOOOOOOOOOOOOOOOOOOOOOOOOWWWFFFFFFFFFFFFFFFFGGFGFFFFFFFFFFFFFFFFFFFFGGGGGGGGGGGGGGGGGGGGGGGWWGGGGGGGGGGGGGGGGGGGGG
OOOOOOOOOOOOOOOOOOOOOOOOOOOOOOOOOOOOOOOOOOOOOOOOOOOOOOOOOOOOOWWWFFFFFFFFFFFFFFFFGGGGFFFFFFFFFFFFFFFFFFFFGGGGGGGGGGGGGGGGGGGGGGGWGGGGGGGGGGGGGGGGGGGGGG
OOOOOOOOOOOOOOOOOOOOOOOOOOOOOOOOOOOOOOOOOOOOOOOOOOOOOOOOOOOOOWWWFFFFFFFFFFFFFFFFFGGGFFFFFFFFFFFFFFFFFFFFFGGGGGGGGGGGGGGGGGGGGGWWWGGGGGGGGGGGGGGGGGGGGG
OOOOOOOOOOOOOOOOOOOOOOOOOOOOOOOOOOOOOOOOOOOOOOOOOOOOOOOOOOOOOWWWFFFFFFFFFFFFFFFFFGGGFFFFFFFFFFFFFFFFFFFGGGGGGGGGGGGGGGGGGGGGGGWWWGFFGGGGGGGGGGGGGGGGGG
OOOOOOOOOOOOOOOOOOOOOOOOOOOOOOOOOOOOOOOOOOOOOOOOOOOOOOOOOOOOOWWWFFFFFFFFFFFFFFFFFGGGGFFFFFFFFFFFFFFFFFFFFGGGGGGGGGGGGGGGGGGGGWWWGFFFFGFFGGGGGGGGGGGGGG
OOOOOOOOOOOOOOOOOOOOOOOOOOOOOOOOOOOOOOOOOOOOOOOOOOOOOOOOOOOOOWWWGGFFFFFFFFFFFGFFFGGGGGGGGFGFFFFFFFFFFFGGGGGGGGGGGGGGGGGGGGGGGGWWGWFFFFFFFGGGGGGGGGGGGG
WWWWOOOOOOOOOOOOOOOOOOOOOOOOOOOOOOOOOOOOOOOOOOOOOOOOOOOOOOOOOWWWGGGFFFFFFFFFFFFFGGGGGGGGGGFFFFFFFFGGGGGGGGGGGGGGGGGGGGGGGGGGGGWWWWWFFFFFFGGGGGGGGGGGGG
WWWWWWOOOOOOOOOOOOOOOOOOOOOOOOOOOOOOOOOOOOOOOOOOOOOOOOOOOOOOOWWWGGGFFFFFFFFFFFGFFGGGGGGGGGGFFFFFFFGGGGGGGGFFFFGGGGGGGGGGGGGGGGGWWWWFFFFFFFFFGGGGGGGGGG
WWWWWWWOOOOOOOOOOOOOOOOOOOOOOOOOOOOOOOOOOOOOOOOOOOOOOOOOOOOOOWWWGGGGFFFFFFFFFFFFFFGGGGGGGGGGFFFFFGGGGGGGGGGFFFFFFGGGGGGGGGGGGGGGWWWWFFFFFFFFGGGGGGGGGG
GGGGWWWWOOOOOOOOOOOOOOOOOOOOOOOOOOOOOOOOOOOOOOOOOOOOOOOOOOOOOWWWGGGGGFFFFFFFFFFFFFFFFFGGGGGGGFGGGGGGGGGGGGGFFFFFFFFGGGGGGGGGGGGGWWWGFFFFFFFFFGGGGGGGGG
GGGGGGWWWOOOOOOOOOOOOOOOOOOOOOOOOOOOOOOOOOOOOOOOOOOOOOOOOOOOWWWGGGGGGGFFFFFFFFFFFFFFFFFGGGGGGGGGGGGGGGGGGGGFFFFFFFFFGFFFGGGGGGGWWWWGGGGFFFFFFGGGGGGGGG
GGGGGGGWWWOOOOOOOOOOOOOOOOOOOOOOOOOOOOOOOOOOOOOOOOOOOOOOOOOOWWWLGGGGGGGGGGFFFFFFFFFFFFFGGGGGGGGGGGGGGGGGFFFFFFFFFFFFFFFFGGGGGGGGWWWWGGGFFFFFFFGGGGGGGG
GGGGGGGGWWWOOOOOOOOOOOOOOOOOOOOOOOOOOOOOOOOOOOOOOOOOOOOOOOOOWWWLLGGGGGGGGFFFFFFFFFFFFFGGGGGGGGGGGGGGGGGGFFFFFFFFFFFFFFFFGGGGGGGGWWWGGGFFFFFFFFFGGGGGGG
GGGGGGGGGWWWOOOOOOOOOOOOOOOOOOOOOOOOOOOOOOOOOOOOOOOOOOOOOOOOWWWLLGGGGGGGFGFFFFFFFFFFGGGGGGGGGGGGGGGGGGGGGFFFFFFFFFFFFFGFFGGGGGGWWWGGGGGFFFFFGFFFGGGGGG
GGGGGGGGGGWWWOOOOOOOOOOOOOOOOOOOOOOOOOOOOOOOOOOOOOOOOOOOOOOWWWLLGGGGGGGFFFFFFFFFFFFFFFGGGGGGGGGGGGGGGGGGGFFFFFFFFFFFFFFFFFGGGGWWWGGGGGGFFFFFFFFFFGGGGG
GGGGGGGGGGGWWWOOOOOOOOOOOOOOOOOOOOOOOOOOOOOOOOOOOOOOOOOOOOOWWWLLGGGGGGGFFFFFFFFFFFFFFFGGGGGGGGGGGGGGGGGGGGFFFFFFFFFFFFFFFFFGGLWWWGGGGGGGFGGFFFFFGGGGGH
GGGGGGGGGGGGWWWOOOOOOOOOOOOOOOOOOOOOOOOOOOOOOOOOOOOOOOOOOOWWWLLGGGGGGGGFFFFFFFFFFFFFFFFFGGGGGGGGGGGGGGGGGGFFFFFFFFFFFFFFFFGGGLLWWGGGGGGGGGGFFFFGGGHHHH
GGGGGGGGGGGGWWWOOOOOOOOOOOOOOOOOOOOOOOOOOOOOOOOOOOOOOOOOOOWWWLLGGGGGGGGGFGFFFFFFFFFFFFFFFGGGGGGGGGGGGGGGGGGFFFFFFFFFFFFFFGGGGLLWWWGGGGGGGGGGFFFGGCHHHH
GGGGGGGGGGGGGWWWOOOOOOOOOOOOOOOOOOOOOOOOOOOOOOOOOOOOOOOOOWWWGGGGGGGGGGGGGGGFFFFFFFFFFFFFFFGGGGGGGGGGGGGGGGGFFFFFFFFFFFFFFGGGGGLWWWGGGGGGGGGGGGGCCCHHHM
GGGGGGGGGGGGGWWWOOOOOOOOOOOOOOOOOOOOOOOOOOOOOOOOOOOOOOOOWWWGGGGGGGGGGGGGGGGFFFFFFFFFFFFFFFGGGGGGGGGGGGGGGGGGFFFFFFFFFFFFFFGGGGGWWWGGGGGGGGGGGGHCCCMMMM
GGGGGGGGGGGGGWWWOOOOOOOOOOOOOOOOOOOOOOOOOOOOOOOOOOOOOOOWWWGGGGGGGGGGGGGGGGGGFFFFFFFFFFFFFFGGGGGGGGGGGGGGGGFFFFFFFFFFFFFFFGGGGGGWWWGGGGGGGGGGGGHCCMMMMM
GGGFGGGGGGGGGGWWWOOOOOOOOOOOOOOOOOOOOOOOOOOOOOOOOOOOOOWWWLGGGGGGGGGGGGGGGGGGGFFGGGFFFFFFFFGGGGGGGGGGGGGGGGFFFFFFFFFFFFFFGGGGGGWWWGGGGGGGGGGGGHHHMMMMMM
FFFFFFGGGGGGGGWWWOOOOOOOOOOOOOOOOOOOOOOOOOOOOOOOOOOOOOWWWLGGGGGGGGGGGGGGGGGGGGGGGGGFFFFFFFFGGGGGGGGGGGGGGGGFFFFFFFFFFFFFGGGGGGGWWWGGGGGGGGGGGHHHMMMMMM
FFFFFFFGGGGGGGWWWOOOOOOOOOOOOOOOOOOOOOOOOOOOOOOOOOOOOWWWLLGGGGGGGGGGGGGGGGGGGGGGGGGGGGGGGGGGGGGGGGGGGGGGGGGGGFFGFFGGFGGFFGGGGGWWWGGGGGGGGGGGHHHMMMMMMP
FFFFFFFFGGGGGGWWWOOOOOOOOOOOOOOOOOOOOOOOOOOOOOOOOOOOOWWWLLGGGGGGGGGGGGGGGGGGGGGGGGGGGGGGGGGGGGGGGGGGGGGGGGGGGGFFGGGFWGWGWWGGGGGGGGGGGGGGGGGGHHHMMMMMPP
FFFFFFFFFGGGGGWWWOOOOOOOOOOOOOOOOOOOOOOOOOOOOOOOOOOOOWWWLLGGGGGGGGGGGGGGGGGGGGGGGGGGGGGGGGGGGGGGGGGGGGGGGGGGGGGFGGGWFWGWWGWGWGGGGGGGGGGGGGGHHHMMMMMMPP
FFFFFFFFFFFGGGWWWOOOOOOOOOOOOOOOOOOOOOOOOOOOOOOOOOOOOWWWLGGGGGGGGGGGGGGGGGGGGGGGGGGGGGGGGGGGGGGGGGGGGGGGGGGGGGGGGGWWWGGGGGGWGGGGGGGGGGGGGGHHHMMMMMMPPP
FFFFFFFFFFFFGGWWWOOOOOOOOOOOOOOOOOOOOOOOOOOOOOOOOOOOOWWWGGGGGGGGGGGGGGGGGGGGGGGGGGGGGGGGGGGGGGGGGGGGGGGGGGGGGGGGGGWWWGLLGGGGGGGGGGGGGGGGGHHHMMMMMMMPPP
FFFFFFFFFFFFGWWWOOOOOOOOOOOOOOOOOOOOOOOOOOOOOOOOOOOOOWWWGGGGGGGGGGGGGGGGGGGGGGGGGGGGGGGGGGGGGGGGGGGGGGGGGGGGGHHHHHWWHHHHHHGGGGGGGGGGGGGGHHHMMMMMMMPPPP
FFFFFFFFFFFFFWWWOOOOOOOOOOOOOOOOOOOOOOOOOOOOOOOOOOOOWWWGGGGGGGGGGGGGGGGGGGGGGGGGGGGGGGGGGGGGGGGGGGGGGGGGGGHHHHHHHWWHHHHHHHHHHHHHGGGGGHHHHHMMMMMMMMPPPP
FFFFFFFFFFFFFWWWOOOOOOOOOOOOOOOOOOOOOOOOOOOOOOOOOOOOWWWGGGGGGGGGGGGGGGGGGGGGGGGGGGGGGGGGGGGGGGGGGGGGGGGGHHHHHHGWWHHHHHHHHHHHHHHHHHHHHHHHHMMMMMMMMPPPPP
GFFFFFFFFFFFWWWOOOOOOOOOOOOOOOOOOOOOOOOOOOOOOOOOOOOOWWWGGGGGGGGGGGGGGGGGGGGGGGGGGGGGGGGGGGGGGGGGGGGGGGHHHHHHHMMMMMMMMMMMMMHHHHHHHHHHHHHHMMMMMMMMPPPPPP
GFFFFFFFFFFFWWWOOOOOOOOOOOOOOOOOOOOOOOOOOOOOOOOOOOOOWWWGGGGGGGGGGGGGGGGGGGGGGGGGGGGGGGGGGGGGGGGGGGGGGHHHHHMMMMMMMMMMMMMMMMMMMMMMHHHHHMMMMMMMMMPPPPPPPP
GGFFFFFFFFFWWWOOOOOOOOOOOOOOOOOOOOOOOOOOOOOOOOOOOOOWWWGGGGGGGGGGGGGGGGGGGGGGGGGGGGGGGGGGGGGGGGGGGGGHHHHHMMMMMMMMMMMMMMMMMMMMMMMMMMMMMMMMMMMMPPPPPPPPPP
GGGFFFFFFFWWWOOOOOOOOOOOOOOOOOOOOOOOOOOOOOOOOOOOOOOWWWGGGGGGGGGGGGGGGGGGGGGGGGGGGGGGGGGGGGGGGGGGGHHRRHMMMMMMMMMPPPPPPPPPPPPPPPMMMMMMMMMMPPPPPPPPPPPPPP
GGGGFGFFWWWWOOOOOOOOOOOOOOOOOOOOOOOOOOOOOOOOOOOOOOOWWWGGGGGGGGGGGGGGGGGGGGGGGGGGGGGGGGGGGGGGGGGGHHRRRMMMMMMPPPPPPPPPPPPPPPPPPPPPPPPPPPPPPPPPPPPPPPPPPI
GGGGGFWWWWWOOOOOOOOOOOOOOOOOOOOOOOOOOOOOOOOOOOOOOOWWWGGGGGGGGGGGGGGGGGGGGGGGGGGGGGGGGGGGGGGGGGHHHHRRRMMMPPPPPPPPPPPPPPPPPPPPPPPPPPPPPPPPPPPPPPPPPPPPPI
LGWWWWWWWWOOOOOOOOOOOOOOOOOOOOOOOOOOOOOOOOOOOOOOOOWWWGGGGGGGGGGGGGGGGGGGGGGGGGGGGGGGGGGGGGGGHHHHHMMRRPPPPPPPPPPPPPPPPPPPPPPPPPPPPPPPPPPPPPPPPPPPPPPPPI
WWWWWWWWOOOOOOOOOOOOOOOOOOOOOOOOOOOOOOOOOOOOOOOOOWWWGGGGGGGGGGGGGGGGGGGGGGGGGGGGGGGGGGGGGGHHHHHHMMMPPPPPPPPPPPPPPPPPPPPPPPPPPPPPPPPPPPPPPPPPPPPPPPPPPP
WWWWWWOOOOOOOOOOOOOOOOOOOOOOOOOOOOOOOOOOOOOOOOOOWWWGGGGGGGGGGGGGGGGGGGGGGGGGGGGGGGGGGGGGHHHHHHMMMPPPPPPPPPPPPPPPPPPPPPPPPPPPPPPPPPPPPPPPPPPPPPPPPPPPPP
WWOOOOOOOOOOOOOOOOOOOOOOOOOOOOOOOOOOOOOOOOOOOOOOWWWGGGGGGGGGGGGGGGGGGGGGGGGGGGGGGGGGGGHHHHHHMMMPPPPPPPPPPPPPPPPPPPPPPPPPPPPPPPPPPPPPPPPPPPPPPPPPPPPPPP
OOOOOOOOOOOOOOOOOOOOOOOOOOOOOOOOOOOOOOOOOOOOOOOWWWGGGGGGGGGGGGGGGGGGGGGGGGGGGGGGGGGHHHHHHHIMMPPPPPPPPPPPPPPPPPPPPPPPPPPPPPPPPPPPPPPPPPPPPPPPPPPPPPPPPP
OOOOOOOOOOOOOOOOOOOOOOOOOOOOOOOOOOOOOOOOOOOOOWWWWGGGGGGGGGGGGGGGGGGGGGGGGGGGGGGHHHHHHHHHMMIIPPPPPPPPPPPPPPPPPPPPPPPPPPPPPPPPPPPPPPPPPPPPPPPPPPPPPPPPPP
OOOOOOOOOOOOOOOOOOOOOOOOOOOOOOOOOOOOOOOOOOOWWWWWGGGGGGGGGGGGGGGGGGGGGGGGGGGHHHHHHHHHHHMMMIIIPPPPPPPPPPPPPPPPPPPPPPPPPPPPPPPPPPPPPPPPPPPPPPPPPPPPPPPPPP
OOOOOOOOOOOOOOOOOOOOOOOOOOOOOOOOOOOOOOOOOWWWWWWGGGGGGGGGGGGGGGGGGGGGGGGGGHHHHHHHHHHMMMMMPIIIPPPPPPPPPPPPPPPPPPPPPPPPPPPPPPPPPPPPPPPPPPPPPPPPPPPPPPPPPP
OOOOOOOOOOOOOOOOOOOOOOOOOOOOOOOOOOOOOOOWWWWWWGGGGGGGGGGGGGGGGGGGGGGGGGGHHHHHHHHMMMMMMPPPPIIIPPPPPPPPPPPPPPPPPPPPPPPPPPPPPPPPPPPPPPPPPPPPPPPPPPPPPPPPPP
OOOOOOOOOOOOOOOOOOOOOOOOOOOOOOOOOOOOOWWWWWWGGGGGGGGGGGGGGGGGGGGGGGGGGGHHHHHMMMMMMMMPPPPPPIIIIPPPPPPPPPPPPPPPPPPPPPPPPPPPPPPPPPPPPPPPPPPPPPPPPPPPPPPPPP
OOOOOOOOOOOOOOOOOOOOOOOOOOOOOOOOOOOWWWWWWGGGGGGGGGGGGGGGGGGGGGGGGGGGGHHHHMMMMMMMMPPPPPPPPIIIPPPPPPPPPPPPPPPPPPPPPPPPPPPPPPPPPPPPPPPPPPPPPPPPPPPPPPPPPP
OOOOOOOOOOOOOOOOOOOOOOOOOOOOOOOOOWWWWWWGGGGGGGGGGGGGGGGGGGGGGGGGGGGGHHHMMMMMMMPPPPPPPPPPPPPPPPPPPPPPPPPPPPPPPPPPPPPPPPPPPPPPPPPPPPPPPPPPPPPPPPPPPPPPPP
OOOOOOOOOOOOOOOOOOOOOOOOOOOOOOOWWWWWWGGGGGGGGGGGGGGGGGGGGGGGGGGGGGGCCHMMMMMMPPPPPPPPPPPPPPPPPPPPPPPPPPPPPPPPPPPPPPPPPPPPPPPPPPPPPPPPPPPPPPPPPPPPPPPPPP
OOOOOOOOOOOOOOOOOOOOOOOOOOOOOOWWWWWGGGGGGGGGGGGGGGGGGGGGGGGGGGGGGGCCCMMMMMMPPPPPPPPPPPPPPPPPPPPPPPPPPPPPPPPPPPPPPPPPPPPPPPPPPPPPPPPPPPPPPPPPPPPPPPPPPP
OOOOOOOOOOOOOOOOOOOOOOOOOOOOWWWWWGGGGGGGGGGGGGGGGGGGGGGGGGGGGGGGGGHCCMMMMMPPPPPPPPPPPPPPPPPPPPPPPPPPPPPPPPPPPPPPPPPPPPPPPPPPPPPPPPPPPPPPPPPPPPPPPPPPPP
OOOOOOOOOOOOOOOOOOOOOOOOOOOWWWWGGGGGGGGGGGGGGGGGGGGGGGGGGGGGGGGGGHHHMMMMMPPPPPPPPPPPPPPPPPPPPPPPPPPPPPPPPPPPPPPPPPPPPPPPPPPPPPPPPPPPPPPPPPPPPPPPPPPPPP
OOOOOOOOOOOOOOOOOOOOOOOOOOWWWWGGGGGGGGGGGGGGGGGGGGGGGGGGGGGGGGGGRHHMMMMMMPPPPPPPPPPPPPPPPPPPPPPPPPPPPPPPPPPPPPPPPPPPPPPPPPPPPPPPPPPPPPPPPPPPPPPPPPPPPP
OOOOOOOOOOOOOOOOOOOOOOOOOWWWGGGGGGGGGGGGGGGGGGGGGGGGGGGGGGGGGGGGRHHMMMMMPPPPPPPPPPPPPPPPPPPPPPPPPPPPPPPPPPPPPPPPPPPPPPPPPPPPPPPPPPPPPPPPPPPPPPPPPPPPPP
OOOOOOOOOOOOOOOOOOOOOOOOWWWGGGGGGGGGGGGGGGGGGGGGGGGGGGGGGGGGGGGRHHMMMMMMPPPPPPPPPPPPPPPPPPPPPPPPPPPPPPPPPPPPPPPPPPPPPPPPPPPPPPPPPPPPPPPPPPPPPPPPPPPPPP
OOOOOOOOOOOOOOOOOOOOOOOWWWGGGGGGGGGGGGGGGGGGGGGGGGGGGGGGGGGGGGHHHMMMMMIIPPPPPPPPPPPPPPPPPPPPPPPPPPPPPPPPPPPPPPPPPPPPPPPPPPPPPPPPPPPPPPPPPPPPPPPPPPPPPP
OOOOOOOOOOOOOOOOOOOOOOWWWGGGGGGGGGGGGGGGGGGGGGGGGGGGGGGGGGGGGGHHHMMMMMIPPPPPPPPPPPPPPPPPPPPPPPPPPPPPPPPPPPPPPPPPPPPPPPPPPPPPPPPPPPPPPPPPPPPPPPPPPPPPPP
OOOOOOOOOOOOOOOOOOOOOWWWGGGGGGGGGGGGGGGGGGGGGGGGGGGGGGGGGGGGGHHHMMMMMMMPPPPPPPPPPPPPPPPPPPPPPPPPPPPPPPPPPPPPPPPPPPPPPPPPPPPPPPPPPPPPPPPPPPPPPPPPPPPPPP
OOOOOOOOOOOOOOOOOOOOOWWWGGGGGGGGGGGGGGGGGGGGGGGGGGGGGGGGGGGGHHHMMMMMMMMPPPPPPPPPPPPPPPPPPPPPPPPPPPPPPPPPPPPPPPPPPPPPPPPPPPPPPPPPPPPPPPPPPPPPPPPPPPPPPP
OOOOOOOOOOOOOOOOOOOOWWWGGGGGGGGGGGGGGGGGGGGGGGGGGGGGGGGGGGHHHHMMMMMMMMMPPPPPPPPPPPPPPPPPPPPPPPPPPPPPPPPPPPPPPPPPPPPPPPPPPPPPPPPPPPPPPPPPPPPPPPPPPPPPPP
OOOOOOOOOOOOOOOOOOOWWWGGGGGGGGGGGGGGGGGGGGGGGGGGGGGGGGGGGHHHHMMMMMMMMMMMPPPPPPPPPPPPPPPPPPPPPPPPPPPPPPPPPPPPPPPPPPPPPPPPPPPPPPPPPPPPPPPPPPPPPPPPPPPPPP
OOOOOOOOOOOOOOOOOOOWWWGGGGGGGGGGGGGGGGGGGGGGGGGGGGGGGGGHHHHHMMMMMMMMMMMMPPPPPPPPPPPPPPPPPPPPPPPPPPPPPPPPPPPPPPPPPPPPPPPPPPPPPPPPPPPPPPPPPPPPPPPPPPPPPP
OOOOOOOOOOOOOOOOOOWWWGGGGGGGGGGGGGGGGGGGGGGGGGGGGGGGGGHHHHMMMMMMMMMMMMMMMPPPPPPPPPPPPPPPPPPPPPPPPPPPPPPPPPPPPPPPPPPPPPPPPPPPPPPPPPPPPPPPPPPPPPPPPPPPPP
OOOOOOOOOOOOOOOOOOWWWGGGGGGGGGGGGGGGGGGGGGGGGGGGGGGGHHHHHMMMMMMMMMMMMMMMMMPPPPPPPPPPPPPPPPPPPPPPPPPPPPPPPPPPPPPPPPPPPPPPPPPPPPPPPPPPPPPPPPPPPPPPPPPPPP
OOOOOOOOOOOOOOOOOOWWWGGGGGGGGGGGGGGGGGGGGGGGGGGGGGHHHHHMMMMMMMMMMMMMMMMMMMMPPPPPPPPPPPPPPPPPPPPPPPPPPPPPPPPPPPPPPPPPPPPPPPPPPPPPPPPPPPPPPPPPPPPPPPPPPP
OOOOOOOOOOOOOOOOOWWWGGGGGGGGGGFFFGGGGGGGGGGGGGGGGHHHHHMMMMMMMMMMMMMMMMMMMMMMMPPPPPPPPPPPPPPPPPPPPPPPPPPPPPPPPPPPPPPPPPPPPPPPPPPPPPPPPPPPPPPPPPPPPPPPPM
OOOOOOOOOOOOOOOOOWWWGGGGGGGGGGFFFFGGGGGGGGGGGGGGHHHHMMMMMMMMMMMMMMMMMMMMMMMMMMMPPPPPPPPPPPPPPPPPPPPPPPPPPPPPPPPPPPPPPPPPPPPPPPPPPPPPPPPPPPPPPPPPPPPPMM
OOOOOOOOOOOOOOOOOWWWGGGGGGGGGGGFFFGFGGGGGGGGGGGHHHMMMMMMMMMMMMMMMMMMMMMMMMMMMMMMPPPPPPPPPPPPPPPPPPPPPPPPPPPPPPPPPPPPPPPPPPPPPPPPPPPPPPPPPPPPPPPPPPPPMM
OOOOOOOOOOOOOOOOWWWGGGGGGGGGFFFFFFFFFGGGGGGGGGGHHHMMMMMMMMMMMMMMMMMMMMMMMMMMMMMMMPPPPPPPPPPPPPPPPPPPPPPPPPPPPPPPPPPPPPPPPPPPPPPPPPPPPPPPPPPPPPPPPPPMMM
OOOOOOOOOOOOOOOOWWWGGGGGGGGFGFFFFFFFFFGGGGGGGGHHHMMMMMMMMMMMMMMMMMMMMMMMMMMMMMMMMMPPPPPPPPPPPPPPPPPPPPPPPPPPPPPPPPPPPPPPPPPPPPPPPPPPPPPPPPPPPPPPPPMMMM
OOOOOOOOOOOOOOOOWWWGGGGGGGGFFFFFFFFFFFGGGGGGGGHHHMMMMMMMMMMMMMMMMMMMMMMMMMMMMMMMMMMPPPPPPPPPPPPPPPPPPPPPPPPPPPPPPPPPPPPPPPPPPPPPPPPPPPPPPPPPPPPPPPMMMM
OOOOOOOOOOOOOOOOWWWGGGGGGFGGFFFFFFFFFFFFGGGGGGHHHMMMMMMMMMMMMMMMMMMMMMMMMMMMMMMMMMMPPPPPPPPPPPPPPPPPPPPPPPPPPPPPPPPPPPPPPPPPPPPPPPPPPPPPPPPPPPPPPPMMMM
OOOOOOOOOOOOOOOWWWGGGGGGGFGGFFFFFFFFFFFFFFGGGGHHHMMMMMMMMMMMMMMMMMMMMMMMMMMMMMMMMMMMPPPPPPPPPPPPPPPPPPPPPPPPPPPPPPPPPPPPPPPPPPPPPPPPPPPPPPPPPPPPPCMMMM
OOOOOOOOOOOOOOOWWWGGGGGGGFFFFFFFFFFFFFFFFGGGGGHHHMMMMMMMMMMMMMMMMMMMMMMMMMMMMMMMMMMMPPPPPPPPPPPPPPPPPPPPPPPPPPPPPPPPPPPPPPPPPPPPPPPPPPPPPPPPPPPPPCMMMM
OOOOOOOOOOOOOOOWWWGGGGGGGGFFGFFFGFFFFFFGGGGGGGHHHMMMMMMMMMMMMMMMMMMMMMMMMMMMMMMMMMMMMPPPPPPPPPPPPPPPPPPPPPPPPPPPPPPPPPPPPPPPPPPPPPPPPPPPPPPPPPPPPMMMMM
OOOOOOOOOOOOOOOWWWGGGGGGFFGGFGGFFFFFFFFFGGGGGGGHHHMMMMMMMMMMMMMMMMMMMMMMMMMMMMMMMMMMMPPPPPPPPPPPPPPPPPPPPPPPPPPPPPPPPPPPPPPPPPPPPPPPPPPPPPPPPPPPPMMMMM
OOOOOOOOOOOOOOWWWGGGGGGGFFFFFFFFFFFFFFFFGGGGGGGHHHMMMMMMMMMMMMMMMMMMMMMMMMMMMMMMMMMMMPPPPPPPPPPPPPPPPPPPPPPPPPPPPPPPPPPPPPPPPPPPPPPPPPPPPPPPPPPPPMMMMM
OOOOOOOOOOOOOOWWWGGGGGGGGFFFFFFFFFFFFFFGGGGGGGGHHHMMMMMMMMMMMMMMMMMMMMMMMMMMMMMMMMMMMPPPPPPPPPPPPPPPPPPPPPPPPPPPPPPPPPPPPPPPPPPPPPPPPPPPPPPPPPPPPMMMMM
OOOOOOOOOOOOOOWWWGGGGGGGGFFFFFFFFFFFFFFFGGGGGGGGHHHMMMMMMMMMMMMCCMMMMMMMMMMMMMMMMMMMMPPPPPPPPPPPPPPPPPPPPPPPPPPPPPPPPPPPPPPPPPPPPPPPPPPPPPPPPPPPPMMMMM
OOOOOOOOOOOOOOWWWGGGGGGGGFFFFFFFFFFFFFFFFGGGGGGGHHHMMMMMMMMMMMMCCMMMMMMMMMMMMMMMMMMMMMPPPPPPPPPPPPPPPPPPPPPPPPPPPPPPPPPPPPPPPPPPPPPPPPPPPPPPPPPPPMMMMM
OOOOOOOOOOOOOOWWWGGGGGGGFGFFFFFFFFFFFFGGGGGGGGGGHHHMMMMMMMMMMMMCCMMMMMMMMMMMMMMMMMMMMMPPPPPPPPPPPPPPPPPPPPPPPPPPPPPPPPPPPPPPPPPPPPPPPPPPPPPPPPPPPMMMMM
OOOOOOOOOOOOOWWWGGGGGGGFFFFFFFFFFFFFFFFGGGGGGGGGGHHHMMMMMMMMMMMCCCMMMMMMMMMMMMMMMMMMMMPPPPPPPPPPPPPPPPPPPPPPPPPPPPPPPPPPPPPPPPPPPPPPPPPPPPPPPPPPPPMMMM
OOOOOOOOOOOOOWWWGGGGGGGFFFFFFFFFFFFFFFGGGGGGGGGGGHHHMMMMMMMMMMMMCMMMMMMMMMMMMMMMMMMMMMMPPPPPPPPPPPPPPPPPPPPPPPPPPPPPPPPPPPPPPPPPPPPPPPPPPPPPPPPPPPMMMM
OOOOOOOOOOOOOWWWGGGGGGGFFFFFFFFFFFFFFFFGGGGGGGGGGHHHMMMMMMMMMMMMMMMMMMMMMWMGMMMMMMMMMMMPPPPPPPPPPPPPPPPPPPPPPPPPPPPPPPPPPPPPPPPPPPPPPPPPPPPPPPPPPPPMMM
OOOOOOOOOOOOWWWGGGGGGGGFFFFFFFFFFFFFFFFFGGGGGGGGGHHHMMMMMMMMMMMMMMMMMMWHWHWHMMMMMMMMMMMPPPPPPPPPPPPPPPPPPPPPPPPPPPPPPPPPIPPPPPPPPPPPPPPPPPPPPPPPPPPMMM
OOOOOOOOOOOWWWWGGGGGGGGGGGFFFFFFFFFFFFFFFFGGGGGGGGHHHMMMMMMMMMMMMMMMMWHWHHHHHMMMMMMMMMMMPPPPPPPPPPPPPPPPPPPPPPPPPPPPPPPIIIPPPPPPPPPPPPPPPPPPPPPPPPPPPM
OOOOOWWWWWWWWWGGGGGGGGGGGFFFFFFFFFFFFFFFFFFFGGGGGGHHHMWMMMMMMMMMWMMMWWHHHHHHHHMMMMMMMMMMPPPPPPPPPPPPPPPPPPPPPPPPPPPPPPPIIPPPPPPPPPPPPPPPPPPPPPPPPPPPPP
WWWWWWWWWWWWWGGGGGGGGGGGGGFFFFFFFFFFFFFFFFFFGGGGGGHHHMWWWMWWWWMWWWWWHHHGGGGGHHHMMMMMMMMMPPPPPPPPPPPPPPPPPPPPPPPPPPPPPPPPPPPPPPPPPPPPPPPPPPPPPPPPPPPPPP
WWWWWWWWWWWWWGWWGGGGGGGGGGFFFFFFFFFFFFFFFFFGGGGGGGHHHMWWMWWMMMWWMMWHHHGGGGGGGHHHMMMMMMMMMPPPPPPPPPPPPPPPPPPPPPPPPPPPPPPPPPPPPPPPPPPPPPPPPPPPPPPPPPPPPP
WWWWWGGGGWWWWWWWWGGGGGGGGGGGGFFFFFFFFFFFFFFGGGGGGGGHHWWWMMMMMMMMMMHHHGGGGGGGGGHHHMMMMMMMCPPPPPPPPPPPPPPPPPPPPPPPPPPPPPPPPPPPPPPPPPPPPPPPPPPPPPPPPPPPPP
GGGGGGGGGGWWWWWWWWGGGGGGGGGGGGFFFFFFFFFFFFFFGGGGGGGHWWWWMMMMMMMMMHHHGGGGGGGGGGHHHMMMMMMMMMPPPPPPPPPPPPPPPPPPPPPPPPPPPPPPPPPPPPPPPPPPPPPPPPPPPPPPPPPPPP
LLGGGGGGGGGWWWWWWWWWWGGWWWGGGGFFFFFFFFFFWFFWGGGGGWWHWWRRMMMMMMMMHHHGGGGGGGGGGGGHHHMMMMMMMMPPPPPPPPPPPPPPPPPPPPPPPPPPPPPPPPPPPPPPPPPPPPPPPPPPPPPPPPPPPP
GGGGGGGGGGGGWWWWWWWWWWWWWWWGGGGFFFFFFFWWWWWWWWWGWWGGHRRRMMMMMMMHHHGGGGGGGGGGGGGGHHHMMMMMMMPPPPPPPPPPPPPPPPPPPPPPPPPPPPPPPPPPPPPPPPPPPPPPPPPPPPPPPPPPPP
GGGGGGGGGGGGGGWWWWWWWWWWWWWWWWWWGWWWWWWWWWWWWWWWWWWGHRRRMMMMMMMHHHGGGGGGGGGGGGGGHHHMMMMMMMMPPPPPPPPPPPPPPPPPPPPPPPPPPPPPPPPPPPPPPPPPPPPPPPPPPPPPPPPPPP
GGGGGGGGGGGGGGGWWWWWWWWWWWWWWWWWWWWWWWWGWWWWWWWWWWWWHRRRMMMMMMHHHGGGGGGGGGGGGGGGGHHHMMMMMMMPPPPPPPPPPPPPPPPPPPPPPPPPPPPPPPPPPPPPPPPPPPPPPPPPPPPPPPPPPP
